County,Agency,Sworn,Reserve,Dispatcher,Total
ALAMEDA COUNTY,ALAMEDA CO SD/CORONER,936,9,31,976
ALAMEDA COUNTY,ALAMEDA PD,69,0,16,85
ALAMEDA COUNTY,ALBANY PD,22,2,6,30
ALAMEDA COUNTY,BAY AREA RAPID TRANSIT PD,217,0,19,236
ALAMEDA COUNTY,BERKELEY PD,162,16,31,209
ALAMEDA COUNTY,CSU EAST BAY PD,12,0,2,14
ALAMEDA COUNTY,EAST BAY REG PARK DPS,61,0,17,78
ALAMEDA COUNTY,EMERYVILLE PD,37,0,10,47
ALAMEDA COUNTY,FREMONT PD,189,9,32,230
ALAMEDA COUNTY,HAYWARD PD,166,21,30,217
ALAMEDA COUNTY,LIVERMORE PD,85,4,19,108
ALAMEDA COUNTY,NEWARK PD,51,1,11,63
ALAMEDA COUNTY,OAKLAND CITY HOUSING AUTH PD,27,1,0,28
ALAMEDA COUNTY,OAKLAND PD,734,5,72,811
ALAMEDA COUNTY,OAKLAND USD PD,8,0,0,8
ALAMEDA COUNTY,OHLONE CCD PD,3,0,0,3
ALAMEDA COUNTY,PIEDMONT PD,21,4,7,32
ALAMEDA COUNTY,PLEASANTON PD,77,1,13,91
ALAMEDA COUNTY,SAN LEANDRO PD,87,0,17,104
ALAMEDA COUNTY,UC BERKELEY PD,45,0,6,51
ALAMEDA COUNTY,UNION CITY PD,68,0,1,69
ALPINE COUNTY,ALPINE CO SD,13,1,1,15
AMADOR COUNTY,AMADOR CO DA,8,0,0,8
AMADOR COUNTY,AMADOR CO SD/CORONER,46,8,11,65
AMADOR COUNTY,IONE PD,8,1,0,9
AMADOR COUNTY,JACKSON PD,9,6,0,15
AMADOR COUNTY,SUTTER CREEK PD,5,3,0,8
BUTTE COUNTY,BUTTE CCD PD,4,0,0,4
BUTTE COUNTY,BUTTE CO DA,18,0,0,18
BUTTE COUNTY,BUTTE CO SD/CORONER,180,21,19,220
BUTTE COUNTY,CHICO PD,91,1,21,113
BUTTE COUNTY,CSU CHICO PD,18,0,4,22
BUTTE COUNTY,GRIDLEY PD,11,7,9,27
BUTTE COUNTY,OROVILLE PD,22,5,7,34
BUTTE COUNTY,PARADISE PD,20,0,7,27
CALAVERAS COUNTY,ANGELS CAMP PD,7,0,0,7
CALAVERAS COUNTY,CALAVERAS CO DA,1,0,0,1
CALAVERAS COUNTY,CALAVERAS CO SD,65,3,9,77
COLUSA COUNTY,COLUSA CO DISTRICT ATTORNEY,1,0,0,1
COLUSA COUNTY,COLUSA COUNTY SD,29,0,8,37
COLUSA COUNTY,COLUSA PD,9,0,0,9
COLUSA COUNTY,WILLIAMS PD,10,0,0,10
CONTRA COSTA COUNTY,ANTIOCH PD,121,2,16,139
CONTRA COSTA COUNTY,BRENTWOOD PD,65,0,14,79
CONTRA COSTA COUNTY,CLAYTON PD,11,0,0,11
CONTRA COSTA COUNTY,CONCORD PD,135,9,17,161
CONTRA COSTA COUNTY,CONTRA COSTA CCD PD,21,0,0,21
CONTRA COSTA COUNTY,CONTRA COSTA CO DA,29,0,0,29
CONTRA COSTA COUNTY,CONTRA COSTA CO SD/CORONER,629,26,42,697
CONTRA COSTA COUNTY,EL CERRITO PD,36,1,0,37
CONTRA COSTA COUNTY,HERCULES PD,22,2,0,24
CONTRA COSTA COUNTY,KENSINGTON PD,9,0,0,9
CONTRA COSTA COUNTY,MARTINEZ PD,34,6,7,47
CONTRA COSTA COUNTY,MORAGA PD,11,2,0,13
CONTRA COSTA COUNTY,OAKLEY PD,33,0,0,33
CONTRA COSTA COUNTY,PINOLE PD,26,0,13,39
CONTRA COSTA COUNTY,PITTSBURG PD,83,1,0,84
CONTRA COSTA COUNTY,PLEASANT HILL PD,43,1,8,52
CONTRA COSTA COUNTY,RICHMOND PD,144,3,19,166
CONTRA COSTA COUNTY,SAN PABLO PD,56,0,0,56
CONTRA COSTA COUNTY,SAN RAMON PD,67,0,0,67
CONTRA COSTA COUNTY,WALNUT CREEK PD,79,29,18,126
DEL NORTE COUNTY,CRESCENT CITY PD,12,0,0,12
DEL NORTE COUNTY,DEL NORTE CO DA,2,0,0,2
DEL NORTE COUNTY,DEL NORTE COUNTY SD,20,10,5,35
EL DORADO COUNTY,EL DORADO CO DA,15,0,0,15
EL DORADO COUNTY,EL DORADO CO SD,163,4,22,189
EL DORADO COUNTY,PLACERVILLE PD,18,1,5,24
EL DORADO COUNTY,SOUTH LAKE TAHOE PD,37,3,7,47
FRESNO COUNTY,CLOVIS PD,102,10,21,133
FRESNO COUNTY,CLOVIS UNIF SCHL DIST PD,15,0,0,15
FRESNO COUNTY,COALINGA PD,17,0,5,22
FRESNO COUNTY,CSU FRESNO DPS,25,0,8,33
FRESNO COUNTY,FIREBAUGH PD,12,5,0,17
FRESNO COUNTY,FOWLER PD,10,0,0,10
FRESNO COUNTY,FRESNO CO DA,50,0,0,50
FRESNO COUNTY,FRESNO CO SD,412,71,42,525
FRESNO COUNTY,FRESNO PD,784,20,102,906
FRESNO COUNTY,FRESNO YOSEMITE INT'L AIRPORT,6,0,0,6
FRESNO COUNTY,HURON PD,12,2,5,19
FRESNO COUNTY,KERMAN PD,23,5,0,28
FRESNO COUNTY,KINGSBURG PD,18,7,0,25
FRESNO COUNTY,MENDOTA PD,14,6,0,20
FRESNO COUNTY,ORANGE COVE PD,11,4,0,15
FRESNO COUNTY,PARLIER PD,17,0,0,17
FRESNO COUNTY,REEDLEY PD,29,3,7,39
FRESNO COUNTY,SANGER PD,35,1,0,36
FRESNO COUNTY,SELMA PD,33,2,7,42
FRESNO COUNTY,STATE CENTER CCD PD,20,0,7,27
GLENN COUNTY,GLENN CO DA,1,0,0,1
GLENN COUNTY,GLENN CO SD/CORONER,46,5,9,60
GLENN COUNTY,ORLAND PD,11,1,0,12
HUMBOLDT COUNTY,ARCATA PD,25,0,7,32
HUMBOLDT COUNTY,CSU HUMBOLDT PD,11,0,6,17
HUMBOLDT COUNTY,EUREKA PD,45,4,13,62
HUMBOLDT COUNTY,FERNDALE PD,7,2,0,9
HUMBOLDT COUNTY,FORTUNA PD,18,0,5,23
HUMBOLDT COUNTY,HUMBOLDT CO DA,10,0,0,10
HUMBOLDT COUNTY,HUMBOLDT CO SD,202,15,14,231
HUMBOLDT COUNTY,HUMBOLDT DEPT WELFARE/INVEST,9,0,0,9
HUMBOLDT COUNTY,RIO DELL PD,5,1,0,6
IMPERIAL COUNTY,BRAWLEY PD,22,4,8,34
IMPERIAL COUNTY,CALEXICO PD,24,2,7,33
IMPERIAL COUNTY,CALIPATRIA PD,6,3,0,9
IMPERIAL COUNTY,EL CENTRO PD,45,1,9,55
IMPERIAL COUNTY,IMPERIAL CO DA,16,0,0,16
IMPERIAL COUNTY,IMPERIAL CO SD,96,11,12,119
IMPERIAL COUNTY,IMPERIAL PD,17,4,0,21
IMPERIAL COUNTY,WESTMORLAND PD,4,3,0,7
INYO COUNTY,BISHOP PD,10,4,7,21
INYO COUNTY,INYO CO DA,2,0,0,2
INYO COUNTY,INYO COUNTY SD,37,8,6,51
KERN COUNTY,ARVIN PD,16,4,5,25
KERN COUNTY,BAKERSFIELD PD,404,9,41,454
KERN COUNTY,BEAR VALLEY PD,5,0,0,5
KERN COUNTY,CALIFORNIA CITY PD,12,6,4,22
KERN COUNTY,CSU BAKERSFIELD DPS,14,0,7,21
KERN COUNTY,DELANO PD,48,2,7,57
KERN COUNTY,KERN CO DA,26,0,0,26
KERN COUNTY,KERN CO-DEPT OF PARKS & REC,6,1,0,7
KERN COUNTY,KERN COUNTY SD,778,26,40,844
KERN COUNTY,KERN HIGH SCHOOL DISTRICT PD,29,0,0,29
KERN COUNTY,MCFARLAND PD,12,1,4,17
KERN COUNTY,RIDGECREST PD,30,11,5,46
KERN COUNTY,SHAFTER PD,29,1,7,37
KERN COUNTY,STALLION SPRINGS PD,3,3,0,6
KERN COUNTY,TAFT PD,12,1,5,18
KERN COUNTY,TEHACHAPI PD,17,2,9,28
KINGS COUNTY,AVENAL PD,18,2,0,20
KINGS COUNTY,CORCORAN PD,18,3,9,30
KINGS COUNTY,HANFORD PD,60,0,16,76
KINGS COUNTY,KINGS CO DA,14,0,0,14
KINGS COUNTY,KINGS CO SHERIFF'S OFFICE,197,5,15,217
KINGS COUNTY,"KINGS CO-HUMAN SVCS,WELFARE FD",2,0,0,2
KINGS COUNTY,LEMOORE PD,32,6,0,38
LAKE COUNTY,CLEARLAKE PD,20,2,7,29
LAKE COUNTY,LAKE CO DA,5,0,0,5
LAKE COUNTY,LAKE CO SD,94,0,7,101
LAKE COUNTY,LAKEPORT PD,11,1,0,12
LASSEN COUNTY,LASSEN CO DA,1,0,0,1
LASSEN COUNTY,LASSEN CO SD,56,3,8,67
LASSEN COUNTY,SUSANVILLE PD,16,0,0,16
LOS ANGELES COUNTY,ALHAMBRA PD,81,3,13,97
LOS ANGELES COUNTY,AMTRAK PD,31,0,0,31
LOS ANGELES COUNTY,ARCADIA PD,61,5,9,75
LOS ANGELES COUNTY,AZUSA PD,55,3,10,68
LOS ANGELES COUNTY,BALDWIN PARK PD,62,0,11,73
LOS ANGELES COUNTY,BALDWIN PARK UNIF SCH DIST PD,6,0,0,6
LOS ANGELES COUNTY,BELL GARDENS PD,44,2,5,51
LOS ANGELES COUNTY,BELL PD,30,3,4,37
LOS ANGELES COUNTY,BEVERLY HILLS PD,131,9,17,157
LOS ANGELES COUNTY,BURBANK AIRPORT AUTH PD,32,0,0,32
LOS ANGELES COUNTY,BURBANK PD,145,13,18,176
LOS ANGELES COUNTY,CA DEPT INDUSTRIAL RELATIONS,3,0,0,3
LOS ANGELES COUNTY,CERRITOS CCD PD,12,0,0,12
LOS ANGELES COUNTY,CLAREMONT PD,37,3,7,47
LOS ANGELES COUNTY,COMPTON CCD PD,5,0,2,7
LOS ANGELES COUNTY,COMPTON UNIF SCH DIST PD,18,0,0,18
LOS ANGELES COUNTY,COVINA PD,57,1,9,67
LOS ANGELES COUNTY,CSU DOMINGUEZ HILLS PD,19,0,8,27
LOS ANGELES COUNTY,CSU LONG BEACH PD,22,0,10,32
LOS ANGELES COUNTY,CSU LOS ANGELES DPS,16,0,5,21
LOS ANGELES COUNTY,CSU NORTHRIDGE DEPT POLICE SVS,19,0,6,25
LOS ANGELES COUNTY,CSU POMONA DPS,21,0,6,27
LOS ANGELES COUNTY,CULVER CITY PD,107,10,0,117
LOS ANGELES COUNTY,DOWNEY PD,118,0,15,133
LOS ANGELES COUNTY,EL CAMINO CCD PD,11,1,5,17
LOS ANGELES COUNTY,EL MONTE PD,116,6,14,136
LOS ANGELES COUNTY,EL SEGUNDO PD,54,0,0,54
LOS ANGELES COUNTY,GARDENA PD,84,5,0,89
LOS ANGELES COUNTY,GLENDALE CCD PD,10,0,0,10
LOS ANGELES COUNTY,GLENDALE PD,225,11,20,256
LOS ANGELES COUNTY,GLENDORA PD,50,3,11,64
LOS ANGELES COUNTY,HACIENDA LA PUENTE USD,5,0,0,5
LOS ANGELES COUNTY,HAWTHORNE PD,90,2,0,92
LOS ANGELES COUNTY,HERMOSA BEACH PD,35,1,0,36
LOS ANGELES COUNTY,HUNTINGTON PARK PD,55,6,7,68
LOS ANGELES COUNTY,INGLEWOOD PD,189,0,19,208
LOS ANGELES COUNTY,INGLEWOOD UNIF SCH DIST PD,2,2,0,4
LOS ANGELES COUNTY,IRWINDALE PD,28,3,6,37
LOS ANGELES COUNTY,LA VERNE PD,38,5,8,51
LOS ANGELES COUNTY,LONG BEACH DISASTER/EMERG COMM,0,0,44,44
LOS ANGELES COUNTY,LONG BEACH PD,806,22,0,828
LOS ANGELES COUNTY,LOS ANGELES CITY PARK RANGER,23,0,0,23
LOS ANGELES COUNTY,LOS ANGELES CO CORONER,54,0,0,54
LOS ANGELES COUNTY,LOS ANGELES CO DA,230,0,0,230
LOS ANGELES COUNTY,LOS ANGELES CO SD,9952,527,494,10973
LOS ANGELES COUNTY,LOS ANGELES PD,9805,392,566,10763
LOS ANGELES COUNTY,LOS ANGELES PORT PD,133,0,8,141
LOS ANGELES COUNTY,LOS ANGELES SCHOOL PD,296,0,0,296
LOS ANGELES COUNTY,LOS ANGELES WORLD AIRPORTS PD,496,0,0,496
LOS ANGELES COUNTY,MANHATTAN BEACH PD,60,1,0,61
LOS ANGELES COUNTY,MONROVIA PD,44,2,11,57
LOS ANGELES COUNTY,MONTEBELLO PD,66,7,9,82
LOS ANGELES COUNTY,MONTEBELLO UNIFIED SCHOOL DIST,3,0,0,3
LOS ANGELES COUNTY,MONTEREY PARK PD,71,17,13,101
LOS ANGELES COUNTY,PALOS VERDES ESTATES PD,19,6,6,31
LOS ANGELES COUNTY,PASADENA CITY CCD PD,9,0,8,17
LOS ANGELES COUNTY,PASADENA PD,217,9,29,255
LOS ANGELES COUNTY,POMONA PD,150,7,27,184
LOS ANGELES COUNTY,REDONDO BEACH PD,86,11,11,108
LOS ANGELES COUNTY,SAN FERNANDO PD,30,20,7,57
LOS ANGELES COUNTY,SAN GABRIEL PD,50,3,5,58
LOS ANGELES COUNTY,SAN MARINO PD,27,0,5,32
LOS ANGELES COUNTY,SANTA MONICA CCD PD,17,0,7,24
LOS ANGELES COUNTY,SANTA MONICA OFFICE EMER MGT,0,0,27,27
LOS ANGELES COUNTY,SANTA MONICA PD,211,0,0,211
LOS ANGELES COUNTY,SIERRA MADRE PD,16,6,7,29
LOS ANGELES COUNTY,SIGNAL HILL PD,30,0,8,38
LOS ANGELES COUNTY,SOUTH BAY REG PUB COMM AUTH,0,0,60,60
LOS ANGELES COUNTY,SOUTH GATE PD,78,1,9,88
LOS ANGELES COUNTY,SOUTH PASADENA PD,33,4,9,46
LOS ANGELES COUNTY,TORRANCE PD,196,0,23,219
LOS ANGELES COUNTY,UC LOS ANGELES PD,54,0,13,67
LOS ANGELES COUNTY,VERNON PD,43,1,7,51
LOS ANGELES COUNTY,WEST COVINA PD,90,6,18,114
LOS ANGELES COUNTY,WHITTIER PD,118,1,14,133
MADERA COUNTY,CHOWCHILLA PD,21,2,9,32
MADERA COUNTY,MADERA CO DA,8,0,0,8
MADERA COUNTY,MADERA CO SD,99,25,10,134
MADERA COUNTY,MADERA PD,68,1,11,80
MARIN COUNTY,BELVEDERE PD,6,1,0,7
MARIN COUNTY,CENTRAL MARIN POLICE AUTHORITY,41,2,1,44
MARIN COUNTY,FAIRFAX PD,10,1,4,15
MARIN COUNTY,MARIN CCD PD,4,0,0,4
MARIN COUNTY,MARIN CO DA,12,0,0,12
MARIN COUNTY,MARIN CO HEALTH & HUMAN SVCS,3,0,0,3
MARIN COUNTY,MARIN CO SD,202,0,41,243
MARIN COUNTY,MARIN MUNCPL WATER DIST,6,0,0,6
MARIN COUNTY,MILL VALLEY PD,20,1,0,21
MARIN COUNTY,NOVATO PD,55,0,11,66
MARIN COUNTY,ROSS PD,8,0,0,8
MARIN COUNTY,SAN RAFAEL PD,67,3,19,89
MARIN COUNTY,SAUSALITO PD,19,0,0,19
MARIN COUNTY,TIBURON PD,11,6,0,17
MARIPOSA COUNTY,MARIPOSA CO DA,1,0,0,1
MARIPOSA COUNTY,MARIPOSA CO SD,56,11,0,67
MENDOCINO COUNTY,FORT BRAGG PD,14,0,0,14
MENDOCINO COUNTY,MENDOCINO CO DA,7,0,0,7
MENDOCINO COUNTY,MENDOCINO CO HEALTH/HUMAN SVCS,6,0,0,6
MENDOCINO COUNTY,MENDOCINO CO SD,118,4,13,135
MENDOCINO COUNTY,UKIAH PD,24,0,12,36
MENDOCINO COUNTY,WILLITS PD,9,0,4,13
MERCED COUNTY,ATWATER PD,23,3,5,31
MERCED COUNTY,DOS PALOS PD,11,2,4,17
MERCED COUNTY,GUSTINE PD,7,5,0,12
MERCED COUNTY,LIVINGSTON PD,16,2,7,25
MERCED COUNTY,LOS BANOS PD,41,1,11,53
MERCED COUNTY,MERCED CCD PD,5,0,0,5
MERCED COUNTY,MERCED CO DA,9,0,0,9
MERCED COUNTY,MERCED CO SD,118,43,17,178
MERCED COUNTY,MERCED PD,91,4,13,108
MERCED COUNTY,UC MERCED PD,18,0,6,24
MODOC COUNTY,ALTURAS PD,9,3,0,12
MODOC COUNTY,MODOC CO SD,12,0,4,16
MONO COUNTY,MAMMOTH LAKES PD,15,0,0,15
MONO COUNTY,MONO CO DA,2,0,0,2
MONO COUNTY,MONO CO SD,24,0,16,40
MONTEREY COUNTY,CARMEL PD,14,0,4,18
MONTEREY COUNTY,CSU MONTEREY BAY PD,15,0,0,15
MONTEREY COUNTY,DEL REY OAKS PD,10,7,0,17
MONTEREY COUNTY,GONZALES PD,10,0,0,10
MONTEREY COUNTY,GREENFIELD PD,20,2,0,22
MONTEREY COUNTY,KING CITY PD,14,0,0,14
MONTEREY COUNTY,MARINA PD,28,0,0,28
MONTEREY COUNTY,MONTEREY CO DA,26,0,0,26
MONTEREY COUNTY,MONTEREY CO EMER COMM,0,0,63,63
MONTEREY COUNTY,MONTEREY CO SHERIFF'S OFFICE,293,3,0,296
MONTEREY COUNTY,MONTEREY PD,49,1,0,50
MONTEREY COUNTY,PACIFIC GROVE PD,19,0,0,19
MONTEREY COUNTY,SALINAS PD,147,0,0,147
MONTEREY COUNTY,SAND CITY PD,10,3,0,13
MONTEREY COUNTY,SEASIDE PD,31,0,0,31
MONTEREY COUNTY,SOLEDAD PD,18,5,0,23
NAPA COUNTY,CALISTOGA PD,11,0,8,19
NAPA COUNTY,NAPA CO DA,12,0,0,12
NAPA COUNTY,NAPA CO SD,109,0,0,109
NAPA COUNTY,NAPA PD,69,0,26,95
NAPA COUNTY,NAPA VALLEY COLLEGE DPS,4,0,0,4
NAPA COUNTY,NAPA VALLEY RR PD,2,0,0,2
NAPA COUNTY,SAINT HELENA PD,10,1,6,17
NEVADA COUNTY,GRASS VALLEY PD,26,9,0,35
NEVADA COUNTY,NEVADA CITY PD,9,5,0,14
NEVADA COUNTY,NEVADA CO DA,5,0,0,5
NEVADA COUNTY,NEVADA CO SD,63,3,12,78
NEVADA COUNTY,TRUCKEE PD,24,3,0,27
ORANGE COUNTY,ANAHEIM PD,369,24,31,424
ORANGE COUNTY,BREA PD,55,0,13,68
ORANGE COUNTY,BUENA PARK PD,86,4,14,104
ORANGE COUNTY,COAST CCD PD,1,0,0,1
ORANGE COUNTY,COSTA MESA PD,129,3,27,159
ORANGE COUNTY,CSU FULLERTON PD,24,0,8,32
ORANGE COUNTY,CYPRESS PD,48,0,0,48
ORANGE COUNTY,FOUNTAIN VALLEY PD,59,0,11,70
ORANGE COUNTY,FULLERTON PD,117,5,16,138
ORANGE COUNTY,GARDEN GROVE PD,172,8,20,200
ORANGE COUNTY,HUNTINGTON BEACH PD,207,4,26,237
ORANGE COUNTY,IRVINE PD,218,1,21,240
ORANGE COUNTY,IRVINE VALLEY CCD PD,8,0,4,12
ORANGE COUNTY,LA HABRA PD,65,6,17,88
ORANGE COUNTY,LA PALMA PD,20,4,8,32
ORANGE COUNTY,LAGUNA BEACH PD,51,3,13,67
ORANGE COUNTY,LOS ALAMITOS PD,20,2,0,22
ORANGE COUNTY,NEWPORT BEACH PD,132,3,17,152
ORANGE COUNTY,ORANGE CO DA,174,0,0,174
ORANGE COUNTY,ORANGE CO SD/CORONER,1922,137,54,2113
ORANGE COUNTY,ORANGE PD,152,5,17,174
ORANGE COUNTY,PLACENTIA PD,47,1,13,61
ORANGE COUNTY,SADDLEBACK CCD PD,6,0,2,8
ORANGE COUNTY,SANTA ANA PD,340,4,36,380
ORANGE COUNTY,SANTA ANA UNIF SCHL DIST PD,28,0,0,28
ORANGE COUNTY,SEAL BEACH PD,37,1,0,38
ORANGE COUNTY,TUSTIN PD,88,7,15,110
ORANGE COUNTY,UC IRVINE PD,47,0,11,58
ORANGE COUNTY,WEST CITIES COMM CTR,0,0,19,19
ORANGE COUNTY,WESTMINSTER PD,85,6,12,103
PLACER COUNTY,AUBURN PD,19,4,8,31
PLACER COUNTY,LINCOLN PD,24,0,6,30
PLACER COUNTY,PLACER CO DA,18,2,0,20
PLACER COUNTY,PLACER COUNTY SD,246,88,25,359
PLACER COUNTY,ROCKLIN PD,62,2,13,77
PLACER COUNTY,ROSEVILLE PD,133,2,25,160
PLACER COUNTY,UNION PACIFIC RAILROAD,33,0,0,33
PLUMAS COUNTY,PLUMAS CO SD,30,5,11,46
RIVERSIDE COUNTY,BANNING PD,25,2,7,34
RIVERSIDE COUNTY,BEAUMONT PD,41,0,11,52
RIVERSIDE COUNTY,BLYTHE PD,20,0,6,26
RIVERSIDE COUNTY,CATHEDRAL CITY PD,47,1,18,66
RIVERSIDE COUNTY,CORONA PD,146,0,25,171
RIVERSIDE COUNTY,DESERT HOT SPRINGS PD,30,1,0,31
RIVERSIDE COUNTY,HEMET PD,70,0,17,87
RIVERSIDE COUNTY,INDIO PD,71,0,12,83
RIVERSIDE COUNTY,MENIFEE PD,58,1,0,59
RIVERSIDE COUNTY,MURRIETA PD,100,5,37,142
RIVERSIDE COUNTY,PALM SPRINGS PD,97,4,15,116
RIVERSIDE COUNTY,RIVERSIDE CCD PD,17,0,0,17
RIVERSIDE COUNTY,RIVERSIDE CO DA,105,0,2,107
RIVERSIDE COUNTY,RIVERSIDE CO PUBLIC SOCIAL SER,21,0,0,21
RIVERSIDE COUNTY,RIVERSIDE CO SD,2005,29,149,2183
RIVERSIDE COUNTY,RIVERSIDE PD,373,0,50,423
RIVERSIDE COUNTY,UC RIVERSIDE PD,28,0,6,34
RIVERSIDE COUNTY,VAL VERDE UNIF SCH DIST PD,6,6,0,12
SACRAMENTO COUNTY,CA ALCOHOLIC BEVERAGE CONTROL,176,0,0,176
SACRAMENTO COUNTY,CA ASSEMBLY SGT AT ARMS LEGIS,22,0,0,22
SACRAMENTO COUNTY,CA DCA BUREAU OF CANNABIS CTRL,31,0,0,31
SACRAMENTO COUNTY,CA DEPT CONSUMER AFF DEN BD,12,0,0,12
SACRAMENTO COUNTY,CA DEPT CONSUMER AFF INVEST,149,0,0,149
SACRAMENTO COUNTY,CA DEPT DEVELOPMENTAL OPS,86,0,0,86
SACRAMENTO COUNTY,CA DEPT EMPLOYMENT DEVELOPMENT,33,0,0,33
SACRAMENTO COUNTY,CA DEPT FISH & WILDLIFE,383,0,0,383
SACRAMENTO COUNTY,CA DEPT HEALTH CARE SVCS,68,0,0,68
SACRAMENTO COUNTY,CA DEPT INSURANCE FRAUD,182,0,0,182
SACRAMENTO COUNTY,CA DEPT JUSTICE,242,0,0,242
SACRAMENTO COUNTY,CA DEPT MOTOR VEHICLES,199,0,0,199
SACRAMENTO COUNTY,CA DEPT PARKS & RECREATION,515,0,40,555
SACRAMENTO COUNTY,CA DEPT PUB HEALTH FOOD/DRUG,78,0,0,78
SACRAMENTO COUNTY,CA DEPT SOCIAL SERVICES,62,0,0,62
SACRAMENTO COUNTY,CA DEPT STATE HOSPITALS,41,0,0,41
SACRAMENTO COUNTY,CA DEPT TOXIC SUBSTANCES CNTL,11,0,0,11
SACRAMENTO COUNTY,CA FRANCHISE TAX BOARD,29,0,0,29
SACRAMENTO COUNTY,CA HIGHWAY PATROL,6933,0,891,7824
SACRAMENTO COUNTY,CA HORSE RACING BOARD,12,0,0,12
SACRAMENTO COUNTY,CA OFFICE OF LE SUPPORT (OLES),5,0,0,5
SACRAMENTO COUNTY,CA SECRETARY OF STATE OFC INV,3,0,0,3
SACRAMENTO COUNTY,CA STATE FAIR PD,5,1,0,6
SACRAMENTO COUNTY,CA STATE LOTTERY,33,0,0,33
SACRAMENTO COUNTY,CAL - OES,18,0,0,18
SACRAMENTO COUNTY,CAL FIRE,153,0,0,153
SACRAMENTO COUNTY,CITRUS HEIGHTS PD,85,11,21,117
SACRAMENTO COUNTY,CSU SACRAMENTO UNIVERSITY PD,19,0,8,27
SACRAMENTO COUNTY,ELK GROVE PD,139,0,22,161
SACRAMENTO COUNTY,FOLSOM PD,76,4,16,96
SACRAMENTO COUNTY,GALT PD,31,2,7,40
SACRAMENTO COUNTY,LOS RIOS CCD PD,19,2,7,28
SACRAMENTO COUNTY,SACRAMENTO CO CORONER,16,0,0,16
SACRAMENTO COUNTY,SACRAMENTO CO DA,35,0,0,35
SACRAMENTO COUNTY,SACRAMENTO CO HUMAN ASST INV,18,0,0,18
SACRAMENTO COUNTY,SACRAMENTO CO REG PARKS DEPT,33,2,0,35
SACRAMENTO COUNTY,SACRAMENTO CO SD,1321,375,68,1764
SACRAMENTO COUNTY,SACRAMENTO PD,686,99,90,875
SACRAMENTO COUNTY,TWIN RIVERS USD PD,16,5,6,27
SAN BENITO COUNTY,HOLLISTER PD,32,2,0,34
SAN BENITO COUNTY,SAN BENITO CO DA,3,0,0,3
SAN BENITO COUNTY,SAN BENITO CO SD,56,12,0,68
SAN BERNARDINO COUNTY,APPLE VALLEY UNIF SCH DIST PD,6,3,0,9
SAN BERNARDINO COUNTY,BARSTOW PD,41,2,9,52
SAN BERNARDINO COUNTY,BURLINGTON NORTHRN SANTA FE RR,35,0,0,35
SAN BERNARDINO COUNTY,CHAFFEY CCD PD,13,0,0,13
SAN BERNARDINO COUNTY,CHINO PD,114,1,19,134
SAN BERNARDINO COUNTY,COLTON PD,53,0,12,65
SAN BERNARDINO COUNTY,CSU SAN BERNARDINO PD,17,0,7,24
SAN BERNARDINO COUNTY,FONTANA PD,183,4,27,214
SAN BERNARDINO COUNTY,FONTANA UNIFIED SCHOOL DIST,15,0,12,27
SAN BERNARDINO COUNTY,HESPERIA UNIFIED SCHOOL DIST,9,0,0,9
SAN BERNARDINO COUNTY,MONTCLAIR PD,41,6,9,56
SAN BERNARDINO COUNTY,ONTARIO PD,258,7,34,299
SAN BERNARDINO COUNTY,REDLANDS PD,82,2,14,98
SAN BERNARDINO COUNTY,RIALTO PD,104,1,12,117
SAN BERNARDINO COUNTY,SAN BERNARDINO CCD PD,10,0,1,11
SAN BERNARDINO COUNTY,SAN BERNARDINO CO DA,59,0,0,59
SAN BERNARDINO COUNTY,SAN BERNARDINO CO HUMAN SVCS,23,0,0,23
SAN BERNARDINO COUNTY,SAN BERNARDINO CO SD,1993,142,193,2328
SAN BERNARDINO COUNTY,SAN BERNARDINO PD,234,12,28,274
SAN BERNARDINO COUNTY,SAN BERNARDINO UNIF SCHL DIST,26,3,9,38
SAN BERNARDINO COUNTY,SNOWLINE JOINT UNIF SCHL DIST,3,3,0,6
SAN BERNARDINO COUNTY,UPLAND PD,70,5,14,89
SAN BERNARDINO COUNTY,VICTOR VALLEY COLLEGE PD,7,3,0,10
SAN DIEGO COUNTY,CA DEPT OF FIN PROT AND INNOV,5,0,0,5
SAN DIEGO COUNTY,CARLSBAD PD,127,1,21,149
SAN DIEGO COUNTY,CHULA VISTA PD,230,2,33,265
SAN DIEGO COUNTY,CORONADO PD,45,2,10,57
SAN DIEGO COUNTY,CSU SAN DIEGO PD,31,0,8,39
SAN DIEGO COUNTY,CSU SAN MARCOS DPS,16,0,6,22
SAN DIEGO COUNTY,EL CAJON PD,114,21,20,155
SAN DIEGO COUNTY,ESCONDIDO PD,145,7,27,179
SAN DIEGO COUNTY,LA MESA PD,62,1,19,82
SAN DIEGO COUNTY,MIRA COSTA CCD PD,7,0,4,11
SAN DIEGO COUNTY,NATIONAL CITY PD,83,4,13,100
SAN DIEGO COUNTY,OCEANSIDE PD,208,1,27,236
SAN DIEGO COUNTY,PALOMAR CCD PD,11,4,0,15
SAN DIEGO COUNTY,SAN DIEGO CCD PD,34,0,11,45
SAN DIEGO COUNTY,SAN DIEGO CITY SCHOOLS PD,36,0,10,46
SAN DIEGO COUNTY,SAN DIEGO CO DA,128,0,0,128
SAN DIEGO COUNTY,SAN DIEGO CO PUBLIC ASST INV,40,0,0,40
SAN DIEGO COUNTY,SAN DIEGO CO SD,2678,88,146,2912
SAN DIEGO COUNTY,"SAN DIEGO HARBOR PD, PORT OF",131,0,11,142
SAN DIEGO COUNTY,SAN DIEGO PD,1860,12,165,2037
SAN DIEGO COUNTY,SOUTHWESTERN CCD PD,10,0,3,13
SAN DIEGO COUNTY,UC SAN DIEGO PD,36,0,10,46
SAN FRANCISCO COUNTY,CSU SAN FRANCISCO PD,21,0,6,27
SAN FRANCISCO COUNTY,SAN FRAN INT'L AIRPORT COMM,0,0,35,35
SAN FRANCISCO COUNTY,SAN FRANCISCO CCD PD,19,0,1,20
SAN FRANCISCO COUNTY,SAN FRANCISCO CO DA,34,0,0,34
SAN FRANCISCO COUNTY,SAN FRANCISCO CO MED EXAM,16,0,0,16
SAN FRANCISCO COUNTY,SAN FRANCISCO CO SD,833,0,0,833
SAN FRANCISCO COUNTY,SAN FRANCISCO DEPT EMER MGT,1,0,204,205
SAN FRANCISCO COUNTY,SAN FRANCISCO PD,2197,32,0,2229
SAN FRANCISCO COUNTY,UC SAN FRANCISCO PD,53,0,9,62
SAN JOAQUIN COUNTY,ESCALON PD,12,9,0,21
SAN JOAQUIN COUNTY,LODI PD,70,6,17,93
SAN JOAQUIN COUNTY,MANTECA PD,73,3,12,88
SAN JOAQUIN COUNTY,PORT OF STOCKTON PD,16,0,0,16
SAN JOAQUIN COUNTY,RIPON PD,22,0,6,28
SAN JOAQUIN COUNTY,SAN JOAQUIN CO DA,37,0,0,37
SAN JOAQUIN COUNTY,SAN JOAQUIN CO SD,307,2,27,336
SAN JOAQUIN COUNTY,SAN JOAQUIN DELTA COLLEGE PD,13,1,5,19
SAN JOAQUIN COUNTY,STOCKTON PD,442,31,54,527
SAN JOAQUIN COUNTY,STOCKTON UNIF SCHL DIST PD,32,1,8,41
SAN JOAQUIN COUNTY,TRACY PD,92,1,15,108
SAN LUIS OBISPO COUNTY,ARROYO GRANDE PD,21,1,0,22
SAN LUIS OBISPO COUNTY,ATASCADERO PD,26,0,4,30
SAN LUIS OBISPO COUNTY,CPSU SAN LUIS OBISPO PD,18,0,6,24
SAN LUIS OBISPO COUNTY,CUESTA CCD DPS,5,0,0,5
SAN LUIS OBISPO COUNTY,GROVER BEACH PD,20,1,5,26
SAN LUIS OBISPO COUNTY,MORRO BAY PD,17,0,0,17
SAN LUIS OBISPO COUNTY,PASO ROBLES PD,36,3,8,47
SAN LUIS OBISPO COUNTY,PISMO BEACH PD,20,0,8,28
SAN LUIS OBISPO COUNTY,SAN LUIS OBISPO CO DA,17,0,0,17
SAN LUIS OBISPO COUNTY,SAN LUIS OBISPO CO SD,306,12,22,340
SAN LUIS OBISPO COUNTY,SAN LUIS OBISPO PD,58,3,12,73
SAN MATEO COUNTY,ATHERTON PD,22,4,10,36
SAN MATEO COUNTY,BELMONT PD,31,0,11,42
SAN MATEO COUNTY,BRISBANE PD,14,0,0,14
SAN MATEO COUNTY,BROADMOOR PD,10,13,0,23
SAN MATEO COUNTY,BURLINGAME PD,38,0,15,53
SAN MATEO COUNTY,COLMA PD,18,1,5,24
SAN MATEO COUNTY,DALY CITY PD,92,0,1,93
SAN MATEO COUNTY,EAST PALO ALTO PD,36,0,0,36
SAN MATEO COUNTY,FOSTER CITY PD,38,3,8,49
SAN MATEO COUNTY,HILLSBOROUGH PD,27,1,6,34
SAN MATEO COUNTY,MENLO PARK PD,43,3,14,60
SAN MATEO COUNTY,PACIFICA PD,29,5,0,34
SAN MATEO COUNTY,REDWOOD CITY PD,84,3,17,104
SAN MATEO COUNTY,SAN BRUNO PD,42,3,12,57
SAN MATEO COUNTY,SAN MATEO CO CORONER,9,0,0,9
SAN MATEO COUNTY,SAN MATEO CO DA,18,0,0,18
SAN MATEO COUNTY,SAN MATEO CO PUB SFTY COMM CTR,0,0,67,67
SAN MATEO COUNTY,SAN MATEO CO SHERIFF'S OFFICE,312,37,0,349
SAN MATEO COUNTY,SAN MATEO PD,105,3,15,123
SAN MATEO COUNTY,SOUTH SAN FRANCISCO PD,76,5,17,98
SANTA BARBARA COUNTY,ALLAN HANCOCK CCD PD,6,2,2,10
SANTA BARBARA COUNTY,GUADALUPE PD,13,1,0,14
SANTA BARBARA COUNTY,LOMPOC PD,39,0,11,50
SANTA BARBARA COUNTY,SANTA BARBARA CO DA,15,0,0,15
SANTA BARBARA COUNTY,SANTA BARBARA CO SD,496,40,34,570
SANTA BARBARA COUNTY,SANTA BARBARA PD,124,12,14,150
SANTA BARBARA COUNTY,SANTA MARIA PD,134,0,21,155
SANTA BARBARA COUNTY,UC SANTA BARBARA PD,35,0,7,42
SANTA CLARA COUNTY,CAMPBELL PD,42,11,15,68
SANTA CLARA COUNTY,CSU SAN JOSE PD,24,0,7,31
SANTA CLARA COUNTY,FOOTHILL-DEANZA CCD PD,9,0,0,9
SANTA CLARA COUNTY,GILROY PD,62,4,13,79
SANTA CLARA COUNTY,LOS ALTOS PD,32,1,10,43
SANTA CLARA COUNTY,LOS GATOS PD,38,4,8,50
SANTA CLARA COUNTY,MILPITAS PD,80,1,16,97
SANTA CLARA COUNTY,MORGAN HILL PD,36,3,9,48
SANTA CLARA COUNTY,MOUNTAIN VIEW PD,86,11,17,114
SANTA CLARA COUNTY,PALO ALTO PD,79,7,17,103
SANTA CLARA COUNTY,SAN JOSE PD,1066,105,158,1329
SANTA CLARA COUNTY,SAN JOSE UNIF SCHL DIST PD,1,0,0,1
SANTA CLARA COUNTY,SAN JOSE/EVERGREEN CCD PD,6,4,0,10
SANTA CLARA COUNTY,SANTA CLARA CO COMM DEPT,0,0,84,84
SANTA CLARA COUNTY,SANTA CLARA CO DA,84,0,0,84
SANTA CLARA COUNTY,SANTA CLARA CO DA-WELFARE FRD,1,0,0,1
SANTA CLARA COUNTY,SANTA CLARA CO SO,1271,52,0,1323
SANTA CLARA COUNTY,SANTA CLARA PD,140,190,21,351
SANTA CLARA COUNTY,SUNNYVALE DPS,206,0,18,224
SANTA CLARA COUNTY,WEST VALLEY CCD PD,9,2,0,11
SANTA CRUZ COUNTY,CAPITOLA PD,19,2,0,21
SANTA CRUZ COUNTY,SANTA CRUZ CO DA,17,0,0,17
SANTA CRUZ COUNTY,SANTA CRUZ CO SD,153,17,0,170
SANTA CRUZ COUNTY,SANTA CRUZ PD,81,0,0,81
SANTA CRUZ COUNTY,SCOTTS VALLEY PD,17,5,6,28
SANTA CRUZ COUNTY,UC SANTA CRUZ PD,23,0,11,34
SANTA CRUZ COUNTY,WATSONVILLE PD,66,1,0,67
SHASTA COUNTY,ANDERSON PD,20,1,0,21
SHASTA COUNTY,REDDING PD,99,1,0,100
SHASTA COUNTY,SHASTA AREA SAFETY COMM AGCY,0,0,40,40
SHASTA COUNTY,SHASTA CO DA,10,0,0,10
SHASTA COUNTY,SHASTA CO MARSHAL,20,0,1,21
SHASTA COUNTY,SHASTA CO SD,120,6,0,126
SIERRA COUNTY,SIERRA CO SHERIFF'S OFFICE,9,2,5,16
SISKIYOU COUNTY,ETNA PD,5,2,0,7
SISKIYOU COUNTY,LAKE SHASTINA DISTRICT PD,3,0,0,3
SISKIYOU COUNTY,MOUNT SHASTA PD,8,3,5,16
SISKIYOU COUNTY,SISKIYOU CO DA,3,0,0,3
SISKIYOU COUNTY,SISKIYOU CO SD,70,10,9,89
SISKIYOU COUNTY,TULELAKE PD,2,0,0,2
SISKIYOU COUNTY,WEED PD,7,1,5,13
SISKIYOU COUNTY,YREKA PD,13,0,9,22
SOLANO COUNTY,BENICIA PD,32,2,13,47
SOLANO COUNTY,CSU CAL MARITIME ACADEMY PD,7,0,0,7
SOLANO COUNTY,DIXON PD,27,0,0,27
SOLANO COUNTY,FAIRFIELD PD,114,0,24,138
SOLANO COUNTY,RIO VISTA PD,1,1,0,2
SOLANO COUNTY,SOLANO CO DA,10,0,0,10
SOLANO COUNTY,SOLANO CO SD,169,12,20,201
SOLANO COUNTY,SOLANO CO SPECIAL INV BUREAU,7,0,0,7
SOLANO COUNTY,SUISUN CITY PD,22,2,11,35
SOLANO COUNTY,VACAVILLE PD,115,2,19,136
SOLANO COUNTY,VALLEJO PD,110,3,25,138
SONOMA COUNTY,CLOVERDALE PD,13,1,7,21
SONOMA COUNTY,COTATI PD,13,1,6,20
SONOMA COUNTY,CSU SONOMA PD,12,0,2,14
SONOMA COUNTY,HEALDSBURG PD,17,0,7,24
SONOMA COUNTY,PETALUMA PD,66,0,15,81
SONOMA COUNTY,ROHNERT PARK DPS,69,0,15,84
SONOMA COUNTY,SANTA ROSA PD,170,0,26,196
SONOMA COUNTY,SEBASTOPOL PD,13,4,6,23
SONOMA COUNTY,SONOMA CO DA,12,0,0,12
SONOMA COUNTY,"SONOMA CO HUM SRV,WLF FRD INV",6,0,0,6
SONOMA COUNTY,SONOMA CO JR COLLEGE DIST PD,9,0,4,13
SONOMA COUNTY,SONOMA CO SHERIFF'S OFFICE,432,0,26,458
SONOMA COUNTY,SONOMA-MARIN AREA RAIL TRANSIT,1,0,0,1
STANISLAUS COUNTY,CERES DPS,48,3,14,65
STANISLAUS COUNTY,CSU STANISLAUS DPS,12,0,3,15
STANISLAUS COUNTY,MODESTO PD,201,7,0,208
STANISLAUS COUNTY,NEWMAN PD,12,2,0,14
STANISLAUS COUNTY,OAKDALE PD,21,6,9,36
STANISLAUS COUNTY,STANISLAUS CO DA,20,0,0,20
STANISLAUS COUNTY,STANISLAUS CO SD,517,29,1,547
STANISLAUS COUNTY,STANISLAUS REGIONAL 9-1-1,1,0,45,46
STANISLAUS COUNTY,TURLOCK PD,78,0,14,92
SUTTER COUNTY,SUTTER CO DA,6,0,0,6
SUTTER COUNTY,SUTTER CO HEALTH & HUMAN SVCS,3,0,0,3
SUTTER COUNTY,SUTTER CO SD,102,9,10,121
SUTTER COUNTY,YUBA CITY PD,64,3,9,76
SUTTER COUNTY,CORNING PD,13,0,4,17
SUTTER COUNTY,RED BLUFF PD,24,3,8,35
SUTTER COUNTY,TEHAMA CO DA,7,0,0,7
SUTTER COUNTY,TEHAMA CO SD,73,9,9,91
TRINITY COUNTY,TRINITY CO DIST ATTORNEY,1,0,0,1
TRINITY COUNTY,TRINITY CO MARSHAL,4,0,0,4
TRINITY COUNTY,TRINITY COUNTY SD,34,5,2,41
TULARE COUNTY,COLLEGE OF THE SEQUOIAS PD,6,1,0,7
TULARE COUNTY,DINUBA PD,32,0,6,38
TULARE COUNTY,EXETER PD,17,6,0,23
TULARE COUNTY,FARMERSVILLE PD,16,0,0,16
TULARE COUNTY,LINDSAY DPS,15,1,0,16
TULARE COUNTY,PORTERVILLE PD,71,4,13,88
TULARE COUNTY,TULARE CO DA,36,0,0,36
TULARE COUNTY,TULARE CO SD,534,16,21,571
TULARE COUNTY,TULARE PD,68,0,11,79
TULARE COUNTY,VISALIA PD,150,0,24,174
TULARE COUNTY,WOODLAKE PD,10,2,0,12
TUOLUMNE COUNTY,SONORA PD,10,1,6,17
TUOLUMNE COUNTY,TUOLUMNE CO DA,2,0,0,2
TUOLUMNE COUNTY,TUOLUMNE CO SD,90,3,12,105
VENTURA COUNTY,CSU CHANNEL ISLANDS PD,13,0,6,19
VENTURA COUNTY,OXNARD PD,216,6,21,243
VENTURA COUNTY,PORT HUENEME PD,20,6,4,30
VENTURA COUNTY,SANTA PAULA PD,32,8,7,47
VENTURA COUNTY,SIMI VALLEY PD,121,0,17,138
VENTURA COUNTY,VENTURA CO CCD PD,14,0,0,14
VENTURA COUNTY,VENTURA CO DA,51,0,0,51
VENTURA COUNTY,VENTURA CO SD,725,12,35,772
VENTURA COUNTY,VENTURA PD,129,0,19,148
YOLO COUNTY,DAVIS PD,57,2,13,72
YOLO COUNTY,UC DAVIS PD,46,0,9,55
YOLO COUNTY,WEST SACRAMENTO PD,72,2,0,74
YOLO COUNTY,WINTERS PD,10,1,0,11
YOLO COUNTY,WOODLAND PD,66,0,0,66
YOLO COUNTY,YOLO CO COMM EMER,0,0,33,33
YOLO COUNTY,YOLO CO DA,13,0,0,13
YOLO COUNTY,YOLO CO SHERIFF'S OFFICE,81,5,0,86
YUBA COUNTY,MARYSVILLE PD,17,11,10,38
YUBA COUNTY,WHEATLAND PD,8,3,0,11
YUBA COUNTY,YUBA CO DA,2,0,0,2
YUBA COUNTY,YUBA CO SD,116,21,13,150
YUBA COUNTY,YUBA COMMUNITY COLL DIST PD,3,0,0,3
YUBA COUNTY,** GRAND TOTAL,84218,3959,8016,96193
