County,Agency,Sworn,Reserve,Dispatcher,Total
ALAMEDA COUNTY,ALAMEDA CO SD/CORONER,941,19,32,992
ALAMEDA COUNTY,ALAMEDA PD,78,0,17,95
ALAMEDA COUNTY,ALBANY PD,22,3,7,32
ALAMEDA COUNTY,AMTRAK PD,32,0,0,32
ALAMEDA COUNTY,BAY AREA RAPID TRANSIT PD,181,0,17,198
ALAMEDA COUNTY,BERKELEY PD,155,16,31,202
ALAMEDA COUNTY,CSU EAST BAY PD,14,0,4,18
ALAMEDA COUNTY,EAST BAY REG PARK DPS,62,3,15,80
ALAMEDA COUNTY,EMERYVILLE PD,40,0,11,51
ALAMEDA COUNTY,FREMONT PD,179,6,30,215
ALAMEDA COUNTY,HAYWARD PD,169,25,30,224
ALAMEDA COUNTY,LIVERMORE PD,87,5,20,112
ALAMEDA COUNTY,NEWARK PD,53,3,13,69
ALAMEDA COUNTY,OAKLAND CITY HOUSING AUTH PD,26,3,0,29
ALAMEDA COUNTY,OAKLAND PD,741,7,68,816
ALAMEDA COUNTY,OAKLAND USD PD,13,0,0,13
ALAMEDA COUNTY,OHLONE CCD PD,2,0,0,2
ALAMEDA COUNTY,PIEDMONT PD,17,6,7,30
ALAMEDA COUNTY,PLEASANTON PD,78,1,17,96
ALAMEDA COUNTY,SAN LEANDRO PD,85,0,15,100
ALAMEDA COUNTY,UC BERKELEY PD,48,0,10,58
ALAMEDA COUNTY,UNION CITY PD,73,0,1,74
ALPINE COUNTY,ALPINE CO SD,13,1,1,15
AMADOR COUNTY,AMADOR CO DA,8,0,0,8
AMADOR COUNTY,AMADOR CO SD/CORONER,43,2,12,57
AMADOR COUNTY,IONE PD,7,3,0,10
AMADOR COUNTY,JACKSON PD,7,7,0,14
AMADOR COUNTY,SUTTER CREEK PD,4,3,0,7
BUTTE COUNTY,BUTTE CCD PD,5,0,0,5
BUTTE COUNTY,BUTTE CO DA,19,0,0,19
BUTTE COUNTY,BUTTE CO SD/CORONER,181,31,17,229
BUTTE COUNTY,CHICO PD,93,0,22,115
BUTTE COUNTY,CSU CHICO PD,15,0,5,20
BUTTE COUNTY,GRIDLEY PD,13,6,8,27
BUTTE COUNTY,OROVILLE PD,19,5,7,31
BUTTE COUNTY,PARADISE PD,22,0,10,32
CALAVERAS COUNTY,ANGELS CAMP PD,4,0,0,4
CALAVERAS COUNTY,CALAVERAS CO DA,1,0,0,1
CALAVERAS COUNTY,CALAVERAS CO SD,48,4,10,62
COLUSA COUNTY,COLUSA CO DISTRICT ATTORNEY,4,0,0,4
COLUSA COUNTY,COLUSA COUNTY SD,31,1,7,39
COLUSA COUNTY,COLUSA PD,7,1,0,8
COLUSA COUNTY,WILLIAMS PD,9,0,0,9
CONTRA COSTA COUNTY,ANTIOCH PD,99,3,16,118
CONTRA COSTA COUNTY,BRENTWOOD PD,65,0,0,65
CONTRA COSTA COUNTY,CLAYTON PD,12,0,0,12
CONTRA COSTA COUNTY,CONCORD PD,143,7,16,166
CONTRA COSTA COUNTY,CONTRA COSTA CCD PD,22,0,0,22
CONTRA COSTA COUNTY,CONTRA COSTA CO DA,27,0,0,27
CONTRA COSTA COUNTY,CONTRA COSTA CO SD/CORONER,640,28,48,716
CONTRA COSTA COUNTY,EL CERRITO PD,39,2,0,41
CONTRA COSTA COUNTY,HERCULES PD,22,2,0,24
CONTRA COSTA COUNTY,KENSINGTON PD,7,1,0,8
CONTRA COSTA COUNTY,MARTINEZ PD,32,5,8,45
CONTRA COSTA COUNTY,MORAGA PD,11,4,0,15
CONTRA COSTA COUNTY,OAKLEY PD,33,0,0,33
CONTRA COSTA COUNTY,PINOLE PD,27,0,12,39
CONTRA COSTA COUNTY,PITTSBURG PD,82,1,0,83
CONTRA COSTA COUNTY,PLEASANT HILL PD,40,2,7,49
CONTRA COSTA COUNTY,RICHMOND PD,163,2,19,184
CONTRA COSTA COUNTY,SAN PABLO PD,52,0,0,52
CONTRA COSTA COUNTY,SAN RAMON PD,64,0,0,64
CONTRA COSTA COUNTY,WALNUT CREEK PD,83,28,15,126
DEL NORTE COUNTY,CRESCENT CITY PD,11,2,0,13
DEL NORTE COUNTY,DEL NORTE CO DA,1,0,0,1
DEL NORTE COUNTY,DEL NORTE COUNTY SD,24,6,5,35
EL DORADO COUNTY,EL DORADO CO DA,17,0,0,17
EL DORADO COUNTY,EL DORADO CO SD,146,4,22,172
EL DORADO COUNTY,PLACERVILLE PD,19,1,4,24
EL DORADO COUNTY,SOUTH LAKE TAHOE PD,35,4,7,46
FRESNO COUNTY,CLOVIS PD,100,11,24,135
FRESNO COUNTY,CLOVIS UNIF SCHL DIST PD,16,0,0,16
FRESNO COUNTY,COALINGA PD,15,1,6,22
FRESNO COUNTY,CSU FRESNO DPS,25,0,7,32
FRESNO COUNTY,FIREBAUGH PD,10,8,0,18
FRESNO COUNTY,FOWLER PD,11,3,0,14
FRESNO COUNTY,FRESNO CO DA,51,0,0,51
FRESNO COUNTY,FRESNO CO SD,423,60,41,524
FRESNO COUNTY,FRESNO PD,815,31,103,949
FRESNO COUNTY,FRESNO YOSEMITE INT'L AIRPORT,3,0,0,3
FRESNO COUNTY,HURON PD,10,3,6,19
FRESNO COUNTY,KERMAN PD,20,8,0,28
FRESNO COUNTY,KINGSBURG PD,16,8,0,24
FRESNO COUNTY,MENDOTA PD,14,8,0,22
FRESNO COUNTY,ORANGE COVE PD,10,3,0,13
FRESNO COUNTY,PARLIER PD,18,1,0,19
FRESNO COUNTY,REEDLEY PD,29,2,7,38
FRESNO COUNTY,SANGER PD,36,1,0,37
FRESNO COUNTY,SELMA PD,34,0,6,40
FRESNO COUNTY,STATE CENTER CCD PD,15,0,5,20
GLENN COUNTY,GLENN CO SD/CORONER,45,4,7,56
GLENN COUNTY,ORLAND PD,11,0,0,11
HUMBOLDT COUNTY,ARCATA PD,26,4,7,37
HUMBOLDT COUNTY,CSU HUMBOLDT DPS,12,0,7,19
HUMBOLDT COUNTY,EUREKA PD,47,2,11,60
HUMBOLDT COUNTY,FERNDALE PD,6,1,0,7
HUMBOLDT COUNTY,FORTUNA PD,18,1,7,26
HUMBOLDT COUNTY,HUMBOLDT CO DA,9,0,0,9
HUMBOLDT COUNTY,HUMBOLDT CO SD,186,11,10,207
HUMBOLDT COUNTY,HUMBOLDT DEPT WELFARE/INVEST,9,0,0,9
HUMBOLDT COUNTY,RIO DELL PD,4,0,0,4
IMPERIAL COUNTY,BRAWLEY PD,29,4,8,41
IMPERIAL COUNTY,CALEXICO PD,20,3,6,29
IMPERIAL COUNTY,CALIPATRIA PD,6,4,0,10
IMPERIAL COUNTY,EL CENTRO PD,45,0,11,56
IMPERIAL COUNTY,IMPERIAL CO DA,17,0,0,17
IMPERIAL COUNTY,IMPERIAL CO SD,96,8,11,115
IMPERIAL COUNTY,IMPERIAL PD,16,2,0,18
IMPERIAL COUNTY,WESTMORLAND PD,6,4,0,10
INYO COUNTY,BISHOP PD,12,5,7,24
INYO COUNTY,INYO CO DA,2,0,0,2
INYO COUNTY,INYO COUNTY SD,35,19,6,60
KERN COUNTY,ARVIN PD,15,3,4,22
KERN COUNTY,BAKERSFIELD PD,396,8,36,440
KERN COUNTY,BEAR VALLEY PD,4,0,0,4
KERN COUNTY,CALIFORNIA CITY PD,9,8,3,20
KERN COUNTY,CSU BAKERSFIELD DPS,12,0,7,19
KERN COUNTY,DELANO PD,50,2,7,59
KERN COUNTY,KERN CO DA,26,0,0,26
KERN COUNTY,KERN CO-DEPT OF PARKS & REC,3,1,0,4
KERN COUNTY,KERN COUNTY SD,828,56,38,922
KERN COUNTY,KERN HIGH SCHOOL DISTRICT PD,27,0,0,27
KERN COUNTY,MCFARLAND PD,12,2,5,19
KERN COUNTY,RIDGECREST PD,30,10,5,45
KERN COUNTY,SHAFTER PD,27,0,7,34
KERN COUNTY,STALLION SPRINGS PD,3,0,0,3
KERN COUNTY,TAFT PD,15,2,5,22
KERN COUNTY,TEHACHAPI PD,17,1,7,25
KINGS COUNTY,AVENAL PD,17,1,0,18
KINGS COUNTY,CORCORAN PD,15,5,6,26
KINGS COUNTY,HANFORD PD,57,0,16,73
KINGS COUNTY,KINGS CO DA,14,0,0,14
KINGS COUNTY,KINGS CO SHERIFF'S OFFICE,196,7,16,219
KINGS COUNTY,"KINGS CO-HUMAN SVCS,WELFARE FD",5,0,0,5
KINGS COUNTY,LEMOORE PD,32,7,0,39
LAKE COUNTY,CLEARLAKE PD,22,2,7,31
LAKE COUNTY,LAKE CO DA,6,0,1,7
LAKE COUNTY,LAKE CO SD,49,1,8,58
LAKE COUNTY,LAKEPORT PD,12,1,0,13
LASSEN COUNTY,LASSEN CO SD,54,5,9,68
LASSEN COUNTY,SUSANVILLE PD,14,0,0,14
LOS ANGELES COUNTY,ALHAMBRA PD,76,4,14,94
LOS ANGELES COUNTY,ARCADIA PD,69,6,9,84
LOS ANGELES COUNTY,AZUSA PD,59,4,10,73
LOS ANGELES COUNTY,BALDWIN PARK PD,68,1,11,80
LOS ANGELES COUNTY,BALDWIN PARK UNIF SCH DIST PD,8,0,0,8
LOS ANGELES COUNTY,BELL GARDENS PD,47,0,6,53
LOS ANGELES COUNTY,BELL PD,28,3,5,36
LOS ANGELES COUNTY,BEVERLY HILLS PD,126,8,17,151
LOS ANGELES COUNTY,BURBANK AIRPORT AUTH PD,31,0,0,31
LOS ANGELES COUNTY,BURBANK PD,147,12,16,175
LOS ANGELES COUNTY,CA DEPT INDUSTRIAL RELATIONS,3,0,0,3
LOS ANGELES COUNTY,CA DEPT OF BUSINESS OVERSIGHT,3,0,0,3
LOS ANGELES COUNTY,CERRITOS CCD PD,14,0,0,14
LOS ANGELES COUNTY,CLAREMONT PD,39,3,7,49
LOS ANGELES COUNTY,COMPTON UNIF SCH DIST PD,18,0,0,18
LOS ANGELES COUNTY,COVINA PD,54,1,9,64
LOS ANGELES COUNTY,CSU DOMINGUEZ HILLS DPS,20,0,7,27
LOS ANGELES COUNTY,CSU LONG BEACH PD,23,0,11,34
LOS ANGELES COUNTY,CSU LOS ANGELES DPS,20,0,5,25
LOS ANGELES COUNTY,CSU NORTHRIDGE DEPT POLICE SVS,20,0,5,25
LOS ANGELES COUNTY,CSU POMONA DPS,18,0,6,24
LOS ANGELES COUNTY,CULVER CITY PD,97,15,0,112
LOS ANGELES COUNTY,DOWNEY PD,116,0,14,130
LOS ANGELES COUNTY,EL CAMINO CCD PD,19,2,7,28
LOS ANGELES COUNTY,EL MONTE PD,118,24,15,157
LOS ANGELES COUNTY,EL SEGUNDO PD,50,0,0,50
LOS ANGELES COUNTY,GARDENA PD,92,5,0,97
LOS ANGELES COUNTY,GLENDALE CCD PD,8,0,0,8
LOS ANGELES COUNTY,GLENDALE PD,222,12,21,255
LOS ANGELES COUNTY,GLENDORA PD,48,4,10,62
LOS ANGELES COUNTY,HACIENDA LA PUENTE USD,6,0,0,6
LOS ANGELES COUNTY,HAWTHORNE PD,90,3,0,93
LOS ANGELES COUNTY,HERMOSA BEACH PD,35,1,0,36
LOS ANGELES COUNTY,HUNTINGTON PARK PD,52,6,8,66
LOS ANGELES COUNTY,INGLEWOOD PD,185,0,17,202
LOS ANGELES COUNTY,INGLEWOOD UNIF SCH DIST PD,5,3,0,8
LOS ANGELES COUNTY,IRWINDALE PD,26,3,6,35
LOS ANGELES COUNTY,LA VERNE PD,40,8,8,56
LOS ANGELES COUNTY,LONG BEACH PD,817,28,67,912
LOS ANGELES COUNTY,LOS ANGELES CITY DPT GEN SVCS,3,0,9,12
LOS ANGELES COUNTY,LOS ANGELES CITY HOUSING AUTH,1,0,0,1
LOS ANGELES COUNTY,LOS ANGELES CITY PARK RANGER,23,0,0,23
LOS ANGELES COUNTY,LOS ANGELES CO CORONER,59,0,0,59
LOS ANGELES COUNTY,LOS ANGELES CO DA,250,0,0,250
LOS ANGELES COUNTY,LOS ANGELES CO SD,9521,609,519,10649
LOS ANGELES COUNTY,LOS ANGELES PD,9782,398,592,10772
LOS ANGELES COUNTY,LOS ANGELES PORT PD,129,0,9,138
LOS ANGELES COUNTY,LOS ANGELES SCHOOL PD,361,0,0,361
LOS ANGELES COUNTY,LOS ANGELES WORLD AIRPORTS PD,502,0,0,502
LOS ANGELES COUNTY,MANHATTAN BEACH PD,59,1,0,60
LOS ANGELES COUNTY,MONROVIA PD,45,2,11,58
LOS ANGELES COUNTY,MONTEBELLO PD,60,7,8,75
LOS ANGELES COUNTY,MONTEBELLO UNIFIED SCHOOL DIST,3,0,0,3
LOS ANGELES COUNTY,MONTEREY PARK PD,69,19,10,98
LOS ANGELES COUNTY,PALOS VERDES ESTATES PD,21,11,8,40
LOS ANGELES COUNTY,PASADENA CITY CCD PD,10,0,6,16
LOS ANGELES COUNTY,PASADENA PD,220,11,30,261
LOS ANGELES COUNTY,POMONA PD,147,11,29,187
LOS ANGELES COUNTY,REDONDO BEACH PD,90,15,11,116
LOS ANGELES COUNTY,SAN FERNANDO PD,27,18,8,53
LOS ANGELES COUNTY,SAN GABRIEL PD,48,3,5,56
LOS ANGELES COUNTY,SAN MARINO PD,23,0,6,29
LOS ANGELES COUNTY,SANTA MONICA CCD PD,17,0,6,23
LOS ANGELES COUNTY,SANTA MONICA OFFICE EMER MGT,0,0,28,28
LOS ANGELES COUNTY,SANTA MONICA PD,216,0,0,216
LOS ANGELES COUNTY,SIERRA MADRE PD,16,5,4,25
LOS ANGELES COUNTY,SIGNAL HILL PD,31,0,7,38
LOS ANGELES COUNTY,SOUTH BAY REG PUB COMM AUTH,0,0,59,59
LOS ANGELES COUNTY,SOUTH GATE PD,76,1,8,85
LOS ANGELES COUNTY,SOUTH PASADENA PD,31,4,6,41
LOS ANGELES COUNTY,TORRANCE PD,215,0,22,237
LOS ANGELES COUNTY,UC LOS ANGELES PD,56,0,13,69
LOS ANGELES COUNTY,VERNON PD,36,1,8,45
LOS ANGELES COUNTY,WEST COVINA PD,92,6,17,115
LOS ANGELES COUNTY,WHITTIER PD,111,1,12,124
MADERA COUNTY,CHOWCHILLA PD,18,2,9,29
MADERA COUNTY,MADERA CO DA,9,0,0,9
MADERA COUNTY,MADERA CO SD,85,21,9,115
MADERA COUNTY,MADERA PD,66,0,12,78
MARIN COUNTY,BELVEDERE PD,4,0,0,4
MARIN COUNTY,CENTRAL MARIN POLICE AUTHORITY,40,5,0,45
MARIN COUNTY,FAIRFAX PD,11,1,4,16
MARIN COUNTY,MARIN CCD PD,6,0,0,6
MARIN COUNTY,MARIN CO DA,12,0,0,12
MARIN COUNTY,MARIN CO HEALTH & HUMAN SVCS,3,0,0,3
MARIN COUNTY,MARIN CO SD,194,0,47,241
MARIN COUNTY,MARIN MUNCPL WATER DIST,6,0,0,6
MARIN COUNTY,MILL VALLEY PD,20,1,0,21
MARIN COUNTY,NOVATO PD,59,0,14,73
MARIN COUNTY,ROSS PD,8,2,0,10
MARIN COUNTY,SAN RAFAEL PD,65,3,18,86
MARIN COUNTY,SAUSALITO PD,19,0,0,19
MARIN COUNTY,TIBURON PD,13,7,0,20
MARIPOSA COUNTY,MARIPOSA CO DA,1,0,0,1
MARIPOSA COUNTY,MARIPOSA CO SD,62,15,0,77
MENDOCINO COUNTY,FORT BRAGG PD,12,0,0,12
MENDOCINO COUNTY,MENDOCINO CO DA,6,0,0,6
MENDOCINO COUNTY,MENDOCINO CO HEALTH/HUMAN SVCS,4,0,0,4
MENDOCINO COUNTY,MENDOCINO CO SD,133,4,15,152
MENDOCINO COUNTY,UKIAH PD,27,1,11,39
MENDOCINO COUNTY,WILLITS PD,10,2,6,18
MERCED COUNTY,ATWATER PD,26,2,5,33
MERCED COUNTY,DOS PALOS PD,8,3,4,15
MERCED COUNTY,GUSTINE PD,7,0,0,7
MERCED COUNTY,LIVINGSTON PD,19,3,7,29
MERCED COUNTY,LOS BANOS PD,39,1,10,50
MERCED COUNTY,MERCED CCD PD,4,0,0,4
MERCED COUNTY,MERCED CO DA,9,0,0,9
MERCED COUNTY,MERCED CO SD,117,36,16,169
MERCED COUNTY,MERCED PD,87,7,13,107
MERCED COUNTY,UC MERCED PD,15,0,6,21
MODOC COUNTY,ALTURAS PD,8,3,0,11
MODOC COUNTY,MODOC CO SD,11,0,5,16
MONO COUNTY,MAMMOTH LAKES PD,13,0,0,13
MONO COUNTY,MONO CO DA,2,0,0,2
MONO COUNTY,MONO CO SD,21,0,15,36
MONTEREY COUNTY,CARMEL PD,15,1,5,21
MONTEREY COUNTY,CSU MONTEREY BAY PD,15,0,0,15
MONTEREY COUNTY,DEL REY OAKS PD,10,7,0,17
MONTEREY COUNTY,GONZALES PD,12,0,0,12
MONTEREY COUNTY,GREENFIELD PD,22,1,0,23
MONTEREY COUNTY,KING CITY PD,14,0,0,14
MONTEREY COUNTY,MARINA PD,22,4,0,26
MONTEREY COUNTY,MONTEREY CO DA,28,0,0,28
MONTEREY COUNTY,MONTEREY CO EMER COMM,0,0,62,62
MONTEREY COUNTY,MONTEREY CO SHERIFF'S OFFICE,294,3,0,297
MONTEREY COUNTY,MONTEREY PD,47,0,0,47
MONTEREY COUNTY,PACIFIC GROVE PD,22,0,0,22
MONTEREY COUNTY,SALINAS PD,148,0,0,148
MONTEREY COUNTY,SAND CITY PD,10,3,0,13
MONTEREY COUNTY,SEASIDE PD,32,1,0,33
MONTEREY COUNTY,SOLEDAD PD,18,6,0,24
NAPA COUNTY,CALISTOGA PD,9,0,8,17
NAPA COUNTY,NAPA CO DA,11,0,0,11
NAPA COUNTY,NAPA CO SD,98,0,0,98
NAPA COUNTY,NAPA PD,76,0,31,107
NAPA COUNTY,NAPA VALLEY COLLEGE DPS,4,0,0,4
NAPA COUNTY,NAPA VALLEY RR PD,2,0,0,2
NAPA COUNTY,SAINT HELENA PD,12,1,9,22
NEVADA COUNTY,GRASS VALLEY PD,26,10,0,36
NEVADA COUNTY,NEVADA CITY PD,10,6,0,16
NEVADA COUNTY,NEVADA CO DA,5,0,0,5
NEVADA COUNTY,NEVADA CO SD,60,4,8,72
NEVADA COUNTY,TRUCKEE PD,23,1,0,24
ORANGE COUNTY,ANAHEIM PD,387,18,32,437
ORANGE COUNTY,BREA PD,59,0,13,72
ORANGE COUNTY,BUENA PARK PD,85,5,16,106
ORANGE COUNTY,COAST CCD PD,1,0,0,1
ORANGE COUNTY,COSTA MESA PD,126,4,22,152
ORANGE COUNTY,CSU FULLERTON PD,28,0,8,36
ORANGE COUNTY,CYPRESS PD,50,0,0,50
ORANGE COUNTY,FOUNTAIN VALLEY PD,58,0,10,68
ORANGE COUNTY,FULLERTON PD,122,4,18,144
ORANGE COUNTY,GARDEN GROVE PD,154,11,18,183
ORANGE COUNTY,HUNTINGTON BEACH PD,214,7,30,251
ORANGE COUNTY,IRVINE PD,213,1,23,237
ORANGE COUNTY,IRVINE VALLEY CCD PD,7,0,5,12
ORANGE COUNTY,LA HABRA PD,64,6,15,85
ORANGE COUNTY,LA PALMA PD,21,3,8,32
ORANGE COUNTY,LAGUNA BEACH PD,55,3,11,69
ORANGE COUNTY,LOS ALAMITOS PD,21,2,0,23
ORANGE COUNTY,NEWPORT BEACH PD,133,5,21,159
ORANGE COUNTY,ORANGE CO DA,178,0,0,178
ORANGE COUNTY,ORANGE CO SD/CORONER,1926,163,58,2147
ORANGE COUNTY,ORANGE PD,152,6,19,177
ORANGE COUNTY,PLACENTIA PD,43,2,10,55
ORANGE COUNTY,SADDLEBACK CCD PD,5,0,2,7
ORANGE COUNTY,SANTA ANA PD,313,5,32,350
ORANGE COUNTY,SANTA ANA UNIF SCHL DIST PD,24,0,0,24
ORANGE COUNTY,SEAL BEACH PD,33,3,0,36
ORANGE COUNTY,TUSTIN PD,88,6,14,108
ORANGE COUNTY,UC IRVINE PD,40,0,11,51
ORANGE COUNTY,WEST CITIES COMM CTR,0,0,22,22
ORANGE COUNTY,WESTMINSTER PD,80,4,15,99
PLACER COUNTY,AUBURN PD,19,3,8,30
PLACER COUNTY,LINCOLN PD,22,0,6,28
PLACER COUNTY,PLACER CO DA,17,0,0,17
PLACER COUNTY,PLACER COUNTY SD,257,91,25,373
PLACER COUNTY,ROCKLIN PD,56,3,13,72
PLACER COUNTY,ROSEVILLE PD,122,2,21,145
PLACER COUNTY,UNION PACIFIC RAILROAD,45,0,0,45
PLUMAS COUNTY,PLUMAS CO SD,32,4,11,47
RIVERSIDE COUNTY,BANNING PD,23,4,6,33
RIVERSIDE COUNTY,BEAUMONT PD,40,0,10,50
RIVERSIDE COUNTY,BLYTHE PD,20,1,7,28
RIVERSIDE COUNTY,CATHEDRAL CITY PD,51,7,19,77
RIVERSIDE COUNTY,CORONA PD,148,0,26,174
RIVERSIDE COUNTY,DESERT HOT SPRINGS PD,28,2,0,30
RIVERSIDE COUNTY,HEMET PD,71,0,16,87
RIVERSIDE COUNTY,INDIO PD,65,0,14,79
RIVERSIDE COUNTY,MURRIETA PD,88,5,21,114
RIVERSIDE COUNTY,PALM SPRINGS PD,93,4,15,112
RIVERSIDE COUNTY,RIVERSIDE CCD PD,21,7,0,28
RIVERSIDE COUNTY,RIVERSIDE CO DA,98,0,2,100
RIVERSIDE COUNTY,RIVERSIDE CO PUBLIC SOCIAL SER,20,0,0,20
RIVERSIDE COUNTY,RIVERSIDE CO SD,1750,35,158,1943
RIVERSIDE COUNTY,RIVERSIDE PD,350,0,50,400
RIVERSIDE COUNTY,UC RIVERSIDE PD,32,0,7,39
RIVERSIDE COUNTY,VAL VERDE UNIF SCH DIST PD,2,1,0,3
SACRAMENTO COUNTY,CA ALCOHOLIC BEVERAGE CONTROL,193,0,0,193
SACRAMENTO COUNTY,CA ASSEMBLY SGT AT ARMS LEGIS,24,0,0,24
SACRAMENTO COUNTY,CA DEPT CONSUMER AFF DEN BD,17,0,0,17
SACRAMENTO COUNTY,CA DEPT CONSUMER AFF INVEST,138,0,0,138
SACRAMENTO COUNTY,CA DEPT DEVELOPMENTAL OPS,84,0,0,84
SACRAMENTO COUNTY,CA DEPT EMPLOYMENT DEVELOPMENT,35,0,0,35
SACRAMENTO COUNTY,CA DEPT FISH & WILDLIFE,383,0,0,383
SACRAMENTO COUNTY,CA DEPT HEALTH CARE SVCS,77,0,0,77
SACRAMENTO COUNTY,CA DEPT INSURANCE FRAUD,180,0,0,180
SACRAMENTO COUNTY,CA DEPT JUSTICE,263,0,0,263
SACRAMENTO COUNTY,CA DEPT MOTOR VEHICLES,200,0,0,200
SACRAMENTO COUNTY,CA DEPT OF MANAGED HEALTH CARE,1,0,0,1
SACRAMENTO COUNTY,CA DEPT PARKS & RECREATION,500,0,37,537
SACRAMENTO COUNTY,CA DEPT PUB HEALTH FOOD/DRUG,87,0,0,87
SACRAMENTO COUNTY,CA DEPT SOCIAL SERVICES,57,0,0,57
SACRAMENTO COUNTY,CA DEPT STATE HOSPITALS,37,0,0,37
SACRAMENTO COUNTY,CA DEPT TOXIC SUBSTANCES CNTL,10,0,0,10
SACRAMENTO COUNTY,CA FRANCHISE TAX BOARD,33,0,0,33
SACRAMENTO COUNTY,CA HIGHWAY PATROL,7261,0,859,8120
SACRAMENTO COUNTY,CA HORSE RACING BOARD,10,0,0,10
SACRAMENTO COUNTY,CA OFFICE OF LE SUPPORT (OLES),4,0,0,4
SACRAMENTO COUNTY,CA SECRETARY OF STATE OFC INV,4,0,0,4
SACRAMENTO COUNTY,CA STATE FAIR PD,5,1,0,6
SACRAMENTO COUNTY,CA STATE LOTTERY,29,0,0,29
SACRAMENTO COUNTY,CAL - OES,16,0,0,16
SACRAMENTO COUNTY,CAL FIRE,172,0,0,172
SACRAMENTO COUNTY,CITRUS HEIGHTS PD,86,11,22,119
SACRAMENTO COUNTY,CSU SACRAMENTO UNIVERSITY PD,22,0,5,27
SACRAMENTO COUNTY,ELK GROVE PD,138,0,22,160
SACRAMENTO COUNTY,FOLSOM PD,71,3,15,89
SACRAMENTO COUNTY,GALT PD,32,2,9,43
SACRAMENTO COUNTY,LOS RIOS CCD PD,22,1,5,28
SACRAMENTO COUNTY,SACRAMENTO CO CORONER,15,0,0,15
SACRAMENTO COUNTY,SACRAMENTO CO DA,44,0,0,44
SACRAMENTO COUNTY,SACRAMENTO CO HUMAN ASST INV,23,0,0,23
SACRAMENTO COUNTY,SACRAMENTO CO REG PARKS DEPT,34,2,0,36
SACRAMENTO COUNTY,SACRAMENTO CO SD,1325,417,73,1815
SACRAMENTO COUNTY,SACRAMENTO PD,666,92,91,849
SACRAMENTO COUNTY,TWIN RIVERS USD PD,18,5,5,28
SAN BENITO COUNTY,HOLLISTER PD,31,1,0,32
SAN BENITO COUNTY,SAN BENITO CO DA,2,0,0,2
SAN BENITO COUNTY,SAN BENITO CO SD,49,9,0,58
SAN BERNARDINO COUNTY,APPLE VALLEY UNIF SCH DIST PD,5,3,1,9
SAN BERNARDINO COUNTY,BARSTOW PD,35,2,10,47
SAN BERNARDINO COUNTY,BURLINGTON NORTHRN SANTA FE RR,34,0,0,34
SAN BERNARDINO COUNTY,CHAFFEY CCD PD,11,0,0,11
SAN BERNARDINO COUNTY,CHINO PD,100,1,20,121
SAN BERNARDINO COUNTY,COLTON PD,50,0,12,62
SAN BERNARDINO COUNTY,CSU SAN BERNARDINO PD,16,0,12,28
SAN BERNARDINO COUNTY,FONTANA PD,185,1,27,213
SAN BERNARDINO COUNTY,FONTANA UNIFIED SCHOOL DIST,17,0,12,29
SAN BERNARDINO COUNTY,HESPERIA UNIFIED SCHOOL DIST,8,0,0,8
SAN BERNARDINO COUNTY,MONTCLAIR PD,44,5,9,58
SAN BERNARDINO COUNTY,ONTARIO PD,276,8,44,328
SAN BERNARDINO COUNTY,REDLANDS PD,83,3,17,103
SAN BERNARDINO COUNTY,RIALTO PD,100,1,9,110
SAN BERNARDINO COUNTY,SAN BERNARDINO CCD PD,8,0,1,9
SAN BERNARDINO COUNTY,SAN BERNARDINO CO DA,60,0,0,60
SAN BERNARDINO COUNTY,SAN BERNARDINO CO SD,2024,165,150,2339
SAN BERNARDINO COUNTY,SAN BERNARDINO PD,237,17,39,293
SAN BERNARDINO COUNTY,SAN BERNARDINO UNIF SCHL DIST,26,6,7,39
SAN BERNARDINO COUNTY,SNOWLINE JOINT UNIF SCHL DIST,2,2,0,4
SAN BERNARDINO COUNTY,UPLAND PD,67,4,14,85
SAN BERNARDINO COUNTY,VICTOR VALLEY COLLEGE PD,7,4,0,11
SAN DIEGO COUNTY,CARLSBAD PD,115,3,22,140
SAN DIEGO COUNTY,CHULA VISTA PD,222,3,24,249
SAN DIEGO COUNTY,CORONADO PD,43,1,8,52
SAN DIEGO COUNTY,CSU SAN DIEGO PD,27,0,9,36
SAN DIEGO COUNTY,CSU SAN MARCOS DPS,19,0,7,26
SAN DIEGO COUNTY,EL CAJON PD,113,22,16,151
SAN DIEGO COUNTY,ESCONDIDO PD,151,11,26,188
SAN DIEGO COUNTY,LA MESA PD,66,2,19,87
SAN DIEGO COUNTY,MIRA COSTA CCD PD,9,0,4,13
SAN DIEGO COUNTY,NATIONAL CITY PD,85,7,14,106
SAN DIEGO COUNTY,OCEANSIDE PD,209,1,28,238
SAN DIEGO COUNTY,PALOMAR CCD PD,12,3,0,15
SAN DIEGO COUNTY,SAN DIEGO CCD PD,35,0,13,48
SAN DIEGO COUNTY,SAN DIEGO CITY SCHOOLS PD,36,0,9,45
SAN DIEGO COUNTY,SAN DIEGO CO DA,130,0,0,130
SAN DIEGO COUNTY,SAN DIEGO CO PUBLIC ASST INV,42,0,0,42
SAN DIEGO COUNTY,SAN DIEGO CO SD,2728,62,149,2939
SAN DIEGO COUNTY,"SAN DIEGO HARBOR PD, PORT OF",126,0,13,139
SAN DIEGO COUNTY,SAN DIEGO PD,1764,15,169,1948
SAN DIEGO COUNTY,SOUTHWESTERN CCD PD,11,0,0,11
SAN DIEGO COUNTY,UC SAN DIEGO PD,39,0,9,48
SAN FRANCISCO COUNTY,CSU SAN FRANCISCO PD,23,0,5,28
SAN FRANCISCO COUNTY,SAN FRAN INT'L AIRPORT COMM,0,0,35,35
SAN FRANCISCO COUNTY,SAN FRANCISCO CCD PD,22,0,1,23
SAN FRANCISCO COUNTY,SAN FRANCISCO CO DA,40,0,0,40
SAN FRANCISCO COUNTY,SAN FRANCISCO CO MED EXAM,12,0,0,12
SAN FRANCISCO COUNTY,SAN FRANCISCO CO SD,835,0,0,835
SAN FRANCISCO COUNTY,SAN FRANCISCO DEPT EMER MGT,1,0,210,211
SAN FRANCISCO COUNTY,SAN FRANCISCO PD,2226,32,0,2258
SAN FRANCISCO COUNTY,SUPREME COURT OF CALIFORNIA,1,0,0,1
SAN FRANCISCO COUNTY,UC SAN FRANCISCO PD,45,0,8,53
SAN JOAQUIN COUNTY,ESCALON PD,9,14,0,23
SAN JOAQUIN COUNTY,LODI PD,66,5,17,88
SAN JOAQUIN COUNTY,MANTECA PD,70,6,12,88
SAN JOAQUIN COUNTY,RIPON PD,22,1,4,27
SAN JOAQUIN COUNTY,SAN JOAQUIN CO DA,36,0,0,36
SAN JOAQUIN COUNTY,SAN JOAQUIN CO SD,317,2,27,346
SAN JOAQUIN COUNTY,SAN JOAQUIN DELTA COLLEGE PD,11,1,8,20
SAN JOAQUIN COUNTY,STOCKTON PD,436,32,53,521
SAN JOAQUIN COUNTY,STOCKTON UNIF SCHL DIST PD,31,1,6,38
SAN JOAQUIN COUNTY,TRACY PD,87,1,15,103
SAN LUIS OBISPO COUNTY,ARROYO GRANDE PD,23,2,0,25
SAN LUIS OBISPO COUNTY,ATASCADERO PD,25,0,4,29
SAN LUIS OBISPO COUNTY,CPSU SAN LUIS OBISPO PD,20,0,8,28
SAN LUIS OBISPO COUNTY,CUESTA CCD DPS,6,0,0,6
SAN LUIS OBISPO COUNTY,GROVER BEACH PD,17,1,5,23
SAN LUIS OBISPO COUNTY,MORRO BAY PD,16,0,0,16
SAN LUIS OBISPO COUNTY,PASO ROBLES PD,32,4,9,45
SAN LUIS OBISPO COUNTY,PISMO BEACH PD,22,1,7,30
SAN LUIS OBISPO COUNTY,SAN LUIS OBISPO CO DA,17,0,0,17
SAN LUIS OBISPO COUNTY,SAN LUIS OBISPO CO SD,299,10,22,331
SAN LUIS OBISPO COUNTY,SAN LUIS OBISPO PD,55,2,13,70
SAN MATEO COUNTY,ATHERTON PD,19,5,10,34
SAN MATEO COUNTY,BELMONT PD,29,0,8,37
SAN MATEO COUNTY,BRISBANE PD,16,0,0,16
SAN MATEO COUNTY,BROADMOOR PD,9,19,0,28
SAN MATEO COUNTY,BURLINGAME PD,37,0,14,51
SAN MATEO COUNTY,COLMA PD,19,3,5,27
SAN MATEO COUNTY,DALY CITY PD,95,0,1,96
SAN MATEO COUNTY,EAST PALO ALTO PD,36,0,0,36
SAN MATEO COUNTY,FOSTER CITY PD,38,3,9,50
SAN MATEO COUNTY,HILLSBOROUGH PD,28,1,6,35
SAN MATEO COUNTY,MENLO PARK PD,47,4,14,65
SAN MATEO COUNTY,PACIFICA PD,31,5,0,36
SAN MATEO COUNTY,REDWOOD CITY PD,85,8,17,110
SAN MATEO COUNTY,SAN BRUNO PD,45,4,9,58
SAN MATEO COUNTY,SAN MATEO CO CORONER,8,0,0,8
SAN MATEO COUNTY,SAN MATEO CO DA,17,0,0,17
SAN MATEO COUNTY,SAN MATEO CO PUB SFTY COMM CTR,0,0,68,68
SAN MATEO COUNTY,SAN MATEO CO SD,338,42,0,380
SAN MATEO COUNTY,SAN MATEO PD,104,5,16,125
SAN MATEO COUNTY,SOUTH SAN FRANCISCO PD,80,5,16,101
SANTA BARBARA COUNTY,ALLAN HANCOCK CCD PD,3,1,1,5
SANTA BARBARA COUNTY,GUADALUPE PD,13,1,0,14
SANTA BARBARA COUNTY,LOMPOC PD,44,0,6,50
SANTA BARBARA COUNTY,SANTA BARBARA CO DA,14,0,0,14
SANTA BARBARA COUNTY,SANTA BARBARA CO SD,461,42,32,535
SANTA BARBARA COUNTY,SANTA BARBARA PD,130,11,15,156
SANTA BARBARA COUNTY,SANTA MARIA PD,122,1,19,142
SANTA BARBARA COUNTY,UC SANTA BARBARA PD,43,0,7,50
SANTA CLARA COUNTY,CAMPBELL PD,42,11,14,67
SANTA CLARA COUNTY,CSU SAN JOSE PD,31,2,8,41
SANTA CLARA COUNTY,FOOTHILL-DEANZA CCD PD,12,0,0,12
SANTA CLARA COUNTY,GILROY PD,62,5,11,78
SANTA CLARA COUNTY,LOS ALTOS PD,30,2,12,44
SANTA CLARA COUNTY,LOS GATOS PD,40,6,8,54
SANTA CLARA COUNTY,MILPITAS PD,83,1,14,98
SANTA CLARA COUNTY,MORGAN HILL PD,38,3,9,50
SANTA CLARA COUNTY,MOUNTAIN VIEW PD,84,11,16,111
SANTA CLARA COUNTY,PALO ALTO PD,78,5,17,100
SANTA CLARA COUNTY,SAN JOSE PD,1020,90,145,1255
SANTA CLARA COUNTY,SAN JOSE UNIF SCHL DIST PD,1,0,0,1
SANTA CLARA COUNTY,SAN JOSE/EVERGREEN CCD PD,7,5,0,12
SANTA CLARA COUNTY,SANTA CLARA CO COMM DEPT,0,0,77,77
SANTA CLARA COUNTY,SANTA CLARA CO DA,80,0,0,80
SANTA CLARA COUNTY,SANTA CLARA CO DA-WELFARE FRD,1,0,0,1
SANTA CLARA COUNTY,SANTA CLARA CO SD,1128,60,0,1188
SANTA CLARA COUNTY,SANTA CLARA PD,142,189,24,355
SANTA CLARA COUNTY,SUNNYVALE DPS,193,0,23,216
SANTA CLARA COUNTY,WEST VALLEY CCD PD,8,1,0,9
SANTA CRUZ COUNTY,CAPITOLA PD,18,2,0,20
SANTA CRUZ COUNTY,SANTA CRUZ CO DA,14,0,0,14
SANTA CRUZ COUNTY,SANTA CRUZ CO SD,144,10,0,154
SANTA CRUZ COUNTY,SANTA CRUZ PD,88,1,0,89
SANTA CRUZ COUNTY,SCOTTS VALLEY PD,20,5,6,31
SANTA CRUZ COUNTY,UC SANTA CRUZ PD,19,0,10,29
SANTA CRUZ COUNTY,WATSONVILLE PD,68,1,0,69
SHASTA COUNTY,ANDERSON PD,21,1,0,22
SHASTA COUNTY,REDDING PD,102,1,0,103
SHASTA COUNTY,SHASTA AREA SAFETY COMM AGCY,0,0,38,38
SHASTA COUNTY,SHASTA CO DA,11,0,0,11
SHASTA COUNTY,SHASTA CO MARSHAL,19,0,2,21
SHASTA COUNTY,SHASTA CO SD,121,6,0,127
SIERRA COUNTY,SIERRA CO SHERIFF'S OFFICE,9,1,0,10
SISKIYOU COUNTY,ETNA PD,2,4,0,6
SISKIYOU COUNTY,LAKE SHASTINA DISTRICT PD,5,0,0,5
SISKIYOU COUNTY,MOUNT SHASTA PD,8,2,3,13
SISKIYOU COUNTY,SISKIYOU CO DA,3,0,0,3
SISKIYOU COUNTY,SISKIYOU CO SD,75,8,11,94
SISKIYOU COUNTY,TULELAKE PD,2,0,0,2
SISKIYOU COUNTY,WEED PD,9,1,6,16
SISKIYOU COUNTY,YREKA PD,14,0,8,22
SOLANO COUNTY,BENICIA PD,32,2,15,49
SOLANO COUNTY,CSU CAL MARITIME ACADEMY PD,9,0,0,9
SOLANO COUNTY,DIXON PD,22,0,0,22
SOLANO COUNTY,FAIRFIELD PD,120,0,22,142
SOLANO COUNTY,RIO VISTA PD,11,1,0,12
SOLANO COUNTY,SOLANO CO DA,11,0,0,11
SOLANO COUNTY,SOLANO CO SD,155,11,18,184
SOLANO COUNTY,SOLANO CO SPECIAL INV BUREAU,7,0,0,7
SOLANO COUNTY,SUISUN CITY PD,24,3,9,36
SOLANO COUNTY,VACAVILLE PD,103,2,20,125
SOLANO COUNTY,VALLEJO PD,106,3,21,130
SONOMA COUNTY,CLOVERDALE PD,11,1,7,19
SONOMA COUNTY,COTATI PD,12,1,6,19
SONOMA COUNTY,CSU SONOMA PD,13,0,3,16
SONOMA COUNTY,HEALDSBURG PD,18,0,7,25
SONOMA COUNTY,PETALUMA PD,65,0,13,78
SONOMA COUNTY,ROHNERT PARK DPS,68,0,14,82
SONOMA COUNTY,SANTA ROSA PD,169,0,28,197
SONOMA COUNTY,SEBASTOPOL PD,14,3,6,23
SONOMA COUNTY,SONOMA CO DA,13,0,0,13
SONOMA COUNTY,"SONOMA CO HUM SRV,WLF FRD INV",6,0,0,6
SONOMA COUNTY,SONOMA CO JR COLLEGE DIST PD,8,0,5,13
SONOMA COUNTY,SONOMA CO SHERIFF'S OFFICE,429,1,26,456
SONOMA COUNTY,SONOMA-MARIN AREA RAIL TRANSIT,1,0,0,1
STANISLAUS COUNTY,CERES DPS,47,2,10,59
STANISLAUS COUNTY,CSU STANISLAUS DPS,11,0,2,13
STANISLAUS COUNTY,MODESTO PD,202,11,0,213
STANISLAUS COUNTY,NEWMAN PD,11,5,0,16
STANISLAUS COUNTY,OAKDALE PD,19,8,11,38
STANISLAUS COUNTY,STANISLAUS CO DA,16,0,0,16
STANISLAUS COUNTY,STANISLAUS CO SD,507,29,1,537
STANISLAUS COUNTY,STANISLAUS REGIONAL 9-1-1,1,0,45,46
STANISLAUS COUNTY,TURLOCK PD,72,0,18,90
SUTTER COUNTY,SUTTER CO DA,6,0,0,6
SUTTER COUNTY,SUTTER CO SD,103,18,10,131
SUTTER COUNTY,YUBA CITY PD,61,3,11,75
SUTTER COUNTY,CORNING PD,13,0,7,20
SUTTER COUNTY,RED BLUFF PD,26,2,7,35
SUTTER COUNTY,TEHAMA CO DA,7,0,0,7
SUTTER COUNTY,TEHAMA CO SD,80,6,7,93
TRINITY COUNTY,TRINITY CO DIST ATTORNEY,1,0,0,1
TRINITY COUNTY,TRINITY CO MARSHAL,3,0,0,3
TRINITY COUNTY,TRINITY COUNTY SD,18,7,0,25
TULARE COUNTY,COLLEGE OF THE SEQUOIAS PD,6,2,0,8
TULARE COUNTY,DINUBA PD,30,5,6,41
TULARE COUNTY,EXETER PD,17,4,1,22
TULARE COUNTY,FARMERSVILLE PD,13,0,1,14
TULARE COUNTY,LINDSAY DPS,15,4,0,19
TULARE COUNTY,PORTERVILLE PD,58,4,14,76
TULARE COUNTY,TULARE CO DA,38,0,0,38
TULARE COUNTY,TULARE CO SD,553,28,24,605
TULARE COUNTY,TULARE PD,68,0,12,80
TULARE COUNTY,VISALIA PD,146,0,23,169
TULARE COUNTY,WOODLAKE PD,8,5,0,13
TUOLUMNE COUNTY,SONORA PD,11,1,6,18
TUOLUMNE COUNTY,TUOLUMNE CO DA,2,0,0,2
TUOLUMNE COUNTY,TUOLUMNE CO SD,97,6,14,117
VENTURA COUNTY,CSU CHANNEL ISLANDS PD,14,0,6,20
VENTURA COUNTY,OXNARD PD,232,8,20,260
VENTURA COUNTY,PORT HUENEME PD,19,4,4,27
VENTURA COUNTY,SANTA PAULA PD,30,14,6,50
VENTURA COUNTY,SIMI VALLEY PD,110,0,17,127
VENTURA COUNTY,VENTURA CO CCD PD,14,0,0,14
VENTURA COUNTY,VENTURA CO DA,50,0,0,50
VENTURA COUNTY,VENTURA CO SD,736,12,36,784
VENTURA COUNTY,VENTURA PD,133,0,13,146
YOLO COUNTY,DAVIS PD,55,3,15,73
YOLO COUNTY,UC DAVIS PD,45,0,9,54
YOLO COUNTY,WEST SACRAMENTO PD,68,3,0,71
YOLO COUNTY,WINTERS PD,11,2,0,13
YOLO COUNTY,WOODLAND PD,64,0,0,64
YOLO COUNTY,YOLO CO COMM EMER,0,0,37,37
YOLO COUNTY,YOLO CO DA,13,0,0,13
YOLO COUNTY,YOLO CO SD,84,5,0,89
YUBA COUNTY,MARYSVILLE PD,18,11,12,41
YUBA COUNTY,WHEATLAND PD,7,4,0,11
YUBA COUNTY,YUBA CO DA,2,0,0,2
YUBA COUNTY,YUBA CO SD,115,22,10,147
YUBA COUNTY,YUBA COMMUNITY COLL DIST PD,4,0,0,4
YUBA COUNTY,** GRAND TOTAL,83478,4349,7997,95824
