County,Agency,Sworn,Reserve,Dispatcher,Total
ALAMEDA COUNTY,ALAMEDA CO SD/CORONER,1001,24,34,1059
ALAMEDA COUNTY,ALAMEDA PD,76,0,17,93
ALAMEDA COUNTY,ALBANY PD,23,2,5,30
ALAMEDA COUNTY,AMTRAK PD,31,0,0,31
ALAMEDA COUNTY,BAY AREA RAPID TRANSIT PD,185,0,18,203
ALAMEDA COUNTY,BERKELEY PD,157,15,32,204
ALAMEDA COUNTY,CSU EAST BAY PD,15,0,7,22
ALAMEDA COUNTY,EAST BAY REG PARK DPS,58,2,17,77
ALAMEDA COUNTY,EMERYVILLE PD,40,0,11,51
ALAMEDA COUNTY,FREMONT PD,179,10,30,219
ALAMEDA COUNTY,HAYWARD PD,185,21,34,240
ALAMEDA COUNTY,LIVERMORE PD,86,7,21,114
ALAMEDA COUNTY,NEWARK PD,54,3,13,70
ALAMEDA COUNTY,OAKLAND CITY HOUSING AUTH PD,28,2,0,30
ALAMEDA COUNTY,OAKLAND PD,748,7,62,817
ALAMEDA COUNTY,OAKLAND USD PD,11,0,0,11
ALAMEDA COUNTY,OHLONE CCD PD,2,0,0,2
ALAMEDA COUNTY,PIEDMONT PD,17,4,8,29
ALAMEDA COUNTY,PLEASANTON PD,78,1,18,97
ALAMEDA COUNTY,SAN LEANDRO PD,89,0,14,103
ALAMEDA COUNTY,UC BERKELEY PD,56,0,10,66
ALAMEDA COUNTY,UNION CITY PD,76,0,1,77
ALPINE COUNTY,ALPINE CO SD,12,1,1,14
AMADOR COUNTY,AMADOR CO DA,8,0,0,8
AMADOR COUNTY,AMADOR CO SD/CORONER,45,1,9,55
AMADOR COUNTY,IONE PD,6,3,0,9
AMADOR COUNTY,JACKSON PD,7,9,0,16
AMADOR COUNTY,SUTTER CREEK PD,4,2,0,6
BUTTE COUNTY,BUTTE CCD PD,4,0,0,4
BUTTE COUNTY,BUTTE CO DA,18,0,0,18
BUTTE COUNTY,BUTTE CO SD/CORONER,179,32,17,228
BUTTE COUNTY,CHICO PD,95,0,21,116
BUTTE COUNTY,CSU CHICO PD,14,0,6,20
BUTTE COUNTY,GRIDLEY PD,13,10,8,31
BUTTE COUNTY,OROVILLE PD,17,5,6,28
BUTTE COUNTY,PARADISE PD,22,0,8,30
CALAVERAS COUNTY,ANGELS CAMP PD,6,1,0,7
CALAVERAS COUNTY,CALAVERAS CO DA,1,0,0,1
CALAVERAS COUNTY,CALAVERAS CO SD,52,4,11,67
COLUSA COUNTY,COLUSA CO DISTRICT ATTORNEY,4,0,0,4
COLUSA COUNTY,COLUSA COUNTY SD,29,2,7,38
COLUSA COUNTY,COLUSA PD,8,1,0,9
COLUSA COUNTY,WILLIAMS PD,11,0,0,11
CONTRA COSTA COUNTY,ANTIOCH PD,97,3,16,116
CONTRA COSTA COUNTY,BRENTWOOD PD,63,0,0,63
CONTRA COSTA COUNTY,CHINO PD,107,1,17,125
CONTRA COSTA COUNTY,CLAYTON PD,11,1,0,12
CONTRA COSTA COUNTY,CONCORD PD,147,10,17,174
CONTRA COSTA COUNTY,CONTRA COSTA CCD PD,22,0,0,22
CONTRA COSTA COUNTY,CONTRA COSTA CO DA,31,0,0,31
CONTRA COSTA COUNTY,CONTRA COSTA CO SD/CORONER,636,30,52,718
CONTRA COSTA COUNTY,EL CERRITO PD,40,1,0,41
CONTRA COSTA COUNTY,HERCULES PD,20,5,0,25
CONTRA COSTA COUNTY,KENSINGTON PD,8,1,0,9
CONTRA COSTA COUNTY,MARTINEZ PD,32,3,9,44
CONTRA COSTA COUNTY,MORAGA PD,12,5,0,17
CONTRA COSTA COUNTY,OAKLEY PD,31,0,0,31
CONTRA COSTA COUNTY,PINOLE PD,25,0,13,38
CONTRA COSTA COUNTY,PITTSBURG PD,83,2,0,85
CONTRA COSTA COUNTY,PLEASANT HILL PD,40,3,8,51
CONTRA COSTA COUNTY,RICHMOND PD,165,2,20,187
CONTRA COSTA COUNTY,SAN PABLO PD,44,0,0,44
CONTRA COSTA COUNTY,SAN RAMON PD,63,0,0,63
CONTRA COSTA COUNTY,WALNUT CREEK PD,85,29,19,133
DEL NORTE COUNTY,CRESCENT CITY PD,11,4,0,15
DEL NORTE COUNTY,DEL NORTE CO DA,2,0,0,2
DEL NORTE COUNTY,DEL NORTE COUNTY SD,24,7,4,35
EL DORADO COUNTY,EL DORADO CO DA,14,0,0,14
EL DORADO COUNTY,EL DORADO CO SD,157,5,22,184
EL DORADO COUNTY,PLACERVILLE PD,18,2,4,24
EL DORADO COUNTY,SOUTH LAKE TAHOE PD,35,5,9,49
FRESNO COUNTY,CLOVIS PD,99,12,22,133
FRESNO COUNTY,CLOVIS UNIF SCHL DIST PD,16,0,0,16
FRESNO COUNTY,COALINGA PD,17,2,6,25
FRESNO COUNTY,CSU FRESNO DPS,26,0,7,33
FRESNO COUNTY,FIREBAUGH PD,11,6,0,17
FRESNO COUNTY,FOWLER PD,12,2,0,14
FRESNO COUNTY,FRESNO CO DA,50,0,0,50
FRESNO COUNTY,FRESNO CO SD,415,63,39,517
FRESNO COUNTY,FRESNO PD,800,38,85,923
FRESNO COUNTY,FRESNO YOSEMITE INT'L AIRPORT,3,0,0,3
FRESNO COUNTY,HURON PD,8,5,4,17
FRESNO COUNTY,KERMAN PD,21,6,0,27
FRESNO COUNTY,KINGSBURG PD,15,12,0,27
FRESNO COUNTY,MENDOTA PD,11,6,0,17
FRESNO COUNTY,ORANGE COVE PD,11,4,0,15
FRESNO COUNTY,PARLIER PD,11,4,0,15
FRESNO COUNTY,REEDLEY PD,30,2,6,38
FRESNO COUNTY,SANGER PD,37,2,0,39
FRESNO COUNTY,SELMA PD,32,0,5,37
FRESNO COUNTY,STATE CENTER CCD PD,17,0,5,22
GLENN COUNTY,GLENN CO SD/CORONER,45,4,7,56
GLENN COUNTY,ORLAND PD,9,0,0,9
HUMBOLDT COUNTY,ARCATA PD,22,4,6,32
HUMBOLDT COUNTY,CSU HUMBOLDT DPS,12,0,8,20
HUMBOLDT COUNTY,EUREKA PD,46,4,12,62
HUMBOLDT COUNTY,FERNDALE PD,6,4,0,10
HUMBOLDT COUNTY,FORTUNA PD,18,2,7,27
HUMBOLDT COUNTY,HUMBOLDT CO DA,9,0,0,9
HUMBOLDT COUNTY,HUMBOLDT CO SD,186,10,12,208
HUMBOLDT COUNTY,HUMBOLDT DEPT WELFARE/INVEST,7,0,0,7
HUMBOLDT COUNTY,RIO DELL PD,3,1,0,4
IMPERIAL COUNTY,BRAWLEY PD,30,4,6,40
IMPERIAL COUNTY,CALEXICO PD,20,3,5,28
IMPERIAL COUNTY,CALIPATRIA PD,6,6,0,12
IMPERIAL COUNTY,EL CENTRO PD,45,0,10,55
IMPERIAL COUNTY,IMPERIAL CO DA,18,0,0,18
IMPERIAL COUNTY,IMPERIAL CO SD,96,14,12,122
IMPERIAL COUNTY,IMPERIAL PD,15,2,0,17
IMPERIAL COUNTY,WESTMORLAND PD,5,6,0,11
INYO COUNTY,BISHOP PD,12,5,7,24
INYO COUNTY,INYO CO DA,2,0,0,2
INYO COUNTY,INYO COUNTY SD,33,18,5,56
KERN COUNTY,ARVIN PD,18,3,5,26
KERN COUNTY,BAKERSFIELD PD,375,8,36,419
KERN COUNTY,BEAR VALLEY PD,4,1,0,5
KERN COUNTY,CALIFORNIA CITY PD,17,7,8,32
KERN COUNTY,CSU BAKERSFIELD DPS,14,0,6,20
KERN COUNTY,DELANO PD,46,2,9,57
KERN COUNTY,KERN CO DA,23,0,0,23
KERN COUNTY,KERN CO-DEPT OF PARKS & REC,5,1,0,6
KERN COUNTY,KERN COUNTY SD,841,51,36,928
KERN COUNTY,KERN HIGH SCHOOL DISTRICT PD,28,0,0,28
KERN COUNTY,MCFARLAND PD,12,1,6,19
KERN COUNTY,RIDGECREST PD,29,12,5,46
KERN COUNTY,SHAFTER PD,25,1,6,32
KERN COUNTY,STALLION SPRINGS PD,4,0,0,4
KERN COUNTY,TAFT PD,17,3,5,25
KERN COUNTY,TEHACHAPI PD,16,1,7,24
KINGS COUNTY,AVENAL PD,16,3,0,19
KINGS COUNTY,CORCORAN PD,14,2,6,22
KINGS COUNTY,HANFORD PD,54,0,15,69
KINGS COUNTY,KINGS CO DA,14,0,0,14
KINGS COUNTY,KINGS CO SHERIFF'S OFFICE,195,9,16,220
KINGS COUNTY,"KINGS CO-HUMAN SVCS,WELFARE FD",5,0,0,5
KINGS COUNTY,LEMOORE PD,32,6,0,38
LAKE COUNTY,CLEARLAKE PD,19,1,5,25
LAKE COUNTY,LAKE CO DA,5,0,1,6
LAKE COUNTY,LAKE CO SD,47,0,9,56
LAKE COUNTY,LAKEPORT PD,11,1,0,12
LASSEN COUNTY,LASSEN CO DA,1,0,0,1
LASSEN COUNTY,LASSEN CO SD,58,6,10,74
LASSEN COUNTY,SUSANVILLE PD,16,0,0,16
LOS ANGELES COUNTY,ALHAMBRA PD,78,3,13,94
LOS ANGELES COUNTY,ARCADIA PD,63,6,9,78
LOS ANGELES COUNTY,AZUSA PD,59,7,11,77
LOS ANGELES COUNTY,BALDWIN PARK PD,69,1,10,80
LOS ANGELES COUNTY,BALDWIN PARK UNIF SCH DIST PD,6,0,0,6
LOS ANGELES COUNTY,BELL GARDENS PD,51,0,6,57
LOS ANGELES COUNTY,BELL PD,30,6,5,41
LOS ANGELES COUNTY,BEVERLY HILLS PD,128,12,18,158
LOS ANGELES COUNTY,BURBANK AIRPORT AUTH PD,30,0,0,30
LOS ANGELES COUNTY,BURBANK PD,150,9,18,177
LOS ANGELES COUNTY,CA DEPT INDUSTRIAL RELATIONS,3,0,0,3
LOS ANGELES COUNTY,CA DEPT OF BUSINESS OVERSIGHT,5,0,0,5
LOS ANGELES COUNTY,CERRITOS CCD PD,13,0,0,13
LOS ANGELES COUNTY,CLAREMONT PD,38,3,7,48
LOS ANGELES COUNTY,COMPTON UNIF SCH DIST PD,21,0,0,21
LOS ANGELES COUNTY,COVINA PD,53,2,11,66
LOS ANGELES COUNTY,CSU DOMINGUEZ HILLS DPS,19,0,7,26
LOS ANGELES COUNTY,CSU LONG BEACH PD,24,0,12,36
LOS ANGELES COUNTY,CSU LOS ANGELES DPS,20,0,7,27
LOS ANGELES COUNTY,CSU NORTHRIDGE DEPT POLICE SVS,22,0,6,28
LOS ANGELES COUNTY,CSU POMONA DPS,20,0,5,25
LOS ANGELES COUNTY,CULVER CITY PD,104,14,0,118
LOS ANGELES COUNTY,DOWNEY PD,110,0,15,125
LOS ANGELES COUNTY,EL CAMINO CCD PD,23,2,7,32
LOS ANGELES COUNTY,EL MONTE PD,117,24,15,156
LOS ANGELES COUNTY,EL SEGUNDO PD,56,0,0,56
LOS ANGELES COUNTY,GARDENA PD,93,6,0,99
LOS ANGELES COUNTY,GLENDALE CCD PD,9,0,0,9
LOS ANGELES COUNTY,GLENDALE PD,228,13,22,263
LOS ANGELES COUNTY,GLENDORA PD,50,4,10,64
LOS ANGELES COUNTY,HACIENDA LA PUENTE USD,6,0,0,6
LOS ANGELES COUNTY,HAWTHORNE PD,91,5,0,96
LOS ANGELES COUNTY,HERMOSA BEACH PD,37,1,0,38
LOS ANGELES COUNTY,HUNTINGTON PARK PD,52,5,8,65
LOS ANGELES COUNTY,INGLEWOOD PD,176,0,18,194
LOS ANGELES COUNTY,INGLEWOOD UNIF SCH DIST PD,7,2,0,9
LOS ANGELES COUNTY,IRWINDALE PD,25,2,6,33
LOS ANGELES COUNTY,LA VERNE PD,37,10,8,55
LOS ANGELES COUNTY,LONG BEACH PD,826,45,66,937
LOS ANGELES COUNTY,LOS ANGELES CITY DPT GEN SVCS,3,0,9,12
LOS ANGELES COUNTY,LOS ANGELES CITY HOUSING AUTH,1,0,0,1
LOS ANGELES COUNTY,LOS ANGELES CITY PARK RANGER,17,0,0,17
LOS ANGELES COUNTY,LOS ANGELES CO CORONER,50,0,0,50
LOS ANGELES COUNTY,LOS ANGELES CO DA,265,0,0,265
LOS ANGELES COUNTY,LOS ANGELES CO SD,9507,653,513,10673
LOS ANGELES COUNTY,LOS ANGELES PD,9800,398,531,10729
LOS ANGELES COUNTY,LOS ANGELES PORT PD,128,0,7,135
LOS ANGELES COUNTY,LOS ANGELES SCHOOL PD,362,0,0,362
LOS ANGELES COUNTY,LOS ANGELES WORLD AIRPORTS PD,525,0,0,525
LOS ANGELES COUNTY,MANHATTAN BEACH PD,59,3,0,62
LOS ANGELES COUNTY,MONROVIA PD,46,3,9,58
LOS ANGELES COUNTY,MONTEBELLO PD,65,9,9,83
LOS ANGELES COUNTY,MONTEBELLO UNIFIED SCHOOL DIST,4,0,0,4
LOS ANGELES COUNTY,MONTEREY PARK PD,70,21,12,103
LOS ANGELES COUNTY,PALOS VERDES ESTATES PD,23,10,9,42
LOS ANGELES COUNTY,PASADENA CITY CCD PD,9,0,7,16
LOS ANGELES COUNTY,PASADENA PD,221,13,25,259
LOS ANGELES COUNTY,POMONA PD,146,11,30,187
LOS ANGELES COUNTY,REDONDO BEACH PD,96,15,14,125
LOS ANGELES COUNTY,SAN FERNANDO PD,28,19,8,55
LOS ANGELES COUNTY,SAN GABRIEL PD,53,4,5,62
LOS ANGELES COUNTY,SAN MARINO PD,25,0,6,31
LOS ANGELES COUNTY,SANTA MONICA CCD PD,20,0,7,27
LOS ANGELES COUNTY,SANTA MONICA OFFICE EMER MGT,0,0,28,28
LOS ANGELES COUNTY,SANTA MONICA PD,207,0,0,207
LOS ANGELES COUNTY,SIERRA MADRE PD,16,6,6,28
LOS ANGELES COUNTY,SIGNAL HILL PD,34,0,7,41
LOS ANGELES COUNTY,SOUTH BAY REG PUB COMM AUTH,0,0,58,58
LOS ANGELES COUNTY,SOUTH GATE PD,76,1,9,86
LOS ANGELES COUNTY,SOUTH PASADENA PD,33,5,7,45
LOS ANGELES COUNTY,TORRANCE PD,207,1,24,232
LOS ANGELES COUNTY,UC LOS ANGELES PD,51,0,13,64
LOS ANGELES COUNTY,VERNON PD,38,0,8,46
LOS ANGELES COUNTY,WEST COVINA PD,96,6,15,117
LOS ANGELES COUNTY,WHITTIER PD,115,1,13,129
MADERA COUNTY,CHOWCHILLA PD,16,2,8,26
MADERA COUNTY,MADERA CO DA,10,0,0,10
MADERA COUNTY,MADERA CO SD,82,22,10,114
MADERA COUNTY,MADERA PD,64,0,11,75
MARIN COUNTY,BELVEDERE PD,7,0,0,7
MARIN COUNTY,CENTRAL MARIN POLICE AUTHORITY,41,4,0,45
MARIN COUNTY,FAIRFAX PD,11,1,4,16
MARIN COUNTY,MARIN CCD PD,6,0,0,6
MARIN COUNTY,MARIN CO DA,12,0,0,12
MARIN COUNTY,MARIN CO SD,200,0,51,251
MARIN COUNTY,MARIN MUNCPL WATER DIST,6,0,0,6
MARIN COUNTY,MILL VALLEY PD,20,1,0,21
MARIN COUNTY,NOVATO PD,59,0,13,72
MARIN COUNTY,ROSS PD,8,2,0,10
MARIN COUNTY,SAN RAFAEL PD,66,4,16,86
MARIN COUNTY,SAUSALITO PD,20,0,0,20
MARIN COUNTY,TIBURON PD,13,7,0,20
MARIPOSA COUNTY,MARIPOSA CO DA,1,0,0,1
MARIPOSA COUNTY,MARIPOSA CO SD,58,14,0,72
MENDOCINO COUNTY,FORT BRAGG PD,15,0,0,15
MENDOCINO COUNTY,MENDOCINO CO DA,6,0,0,6
MENDOCINO COUNTY,MENDOCINO CO HEALTH/HUMAN SVCS,5,0,0,5
MENDOCINO COUNTY,MENDOCINO CO SD,134,4,15,153
MENDOCINO COUNTY,UKIAH PD,32,0,11,43
MENDOCINO COUNTY,WILLITS PD,11,3,5,19
MERCED COUNTY,ATWATER PD,25,3,5,33
MERCED COUNTY,DOS PALOS PD,7,4,5,16
MERCED COUNTY,GUSTINE PD,9,0,0,9
MERCED COUNTY,LIVINGSTON PD,20,4,6,30
MERCED COUNTY,LOS BANOS PD,40,1,10,51
MERCED COUNTY,MERCED CCD PD,4,0,0,4
MERCED COUNTY,MERCED CO DA,7,0,0,7
MERCED COUNTY,MERCED CO SD,105,31,13,149
MERCED COUNTY,MERCED PD,86,10,12,108
MERCED COUNTY,UC MERCED PD,11,0,5,16
MODOC COUNTY,ALTURAS PD,7,3,0,10
MODOC COUNTY,MODOC CO SD,10,0,6,16
MONO COUNTY,MAMMOTH LAKES PD,11,1,0,12
MONO COUNTY,MONO CO DA,1,0,0,1
MONO COUNTY,MONO CO SD,21,0,15,36
MONTEREY COUNTY,CARMEL PD,13,0,5,18
MONTEREY COUNTY,CSU MONTEREY BAY PD,12,0,0,12
MONTEREY COUNTY,DEL REY OAKS PD,6,5,0,11
MONTEREY COUNTY,GONZALES PD,10,0,0,10
MONTEREY COUNTY,GREENFIELD PD,19,1,0,20
MONTEREY COUNTY,KING CITY PD,17,0,0,17
MONTEREY COUNTY,MARINA PD,26,2,0,28
MONTEREY COUNTY,MONTEREY CO DA,29,0,0,29
MONTEREY COUNTY,MONTEREY CO EMER COMM,0,0,66,66
MONTEREY COUNTY,MONTEREY CO SHERIFF'S OFFICE,306,3,0,309
MONTEREY COUNTY,MONTEREY PD,49,0,0,49
MONTEREY COUNTY,MONTEREY REG AIRPORT DIST PD,6,0,0,6
MONTEREY COUNTY,PACIFIC GROVE PD,20,4,0,24
MONTEREY COUNTY,SALINAS PD,147,7,0,154
MONTEREY COUNTY,SAND CITY PD,10,4,0,14
MONTEREY COUNTY,SEASIDE PD,30,1,0,31
MONTEREY COUNTY,SOLEDAD PD,15,7,0,22
NAPA COUNTY,CALISTOGA PD,11,0,6,17
NAPA COUNTY,NAPA CO DA,10,0,0,10
NAPA COUNTY,NAPA CO SD,103,0,0,103
NAPA COUNTY,NAPA PD,72,0,30,102
NAPA COUNTY,NAPA VALLEY COLLEGE DPS,4,0,0,4
NAPA COUNTY,NAPA VALLEY RR PD,2,0,0,2
NAPA COUNTY,SAINT HELENA PD,12,1,7,20
NEVADA COUNTY,GRASS VALLEY PD,24,8,0,32
NEVADA COUNTY,NEVADA CITY PD,12,5,0,17
NEVADA COUNTY,NEVADA CO DA,4,0,0,4
NEVADA COUNTY,NEVADA CO SD,61,5,10,76
NEVADA COUNTY,TRUCKEE PD,23,2,0,25
ORANGE COUNTY,ANAHEIM PD,390,5,34,429
ORANGE COUNTY,BREA PD,58,0,15,73
ORANGE COUNTY,BUENA PARK PD,87,5,19,111
ORANGE COUNTY,COAST CCD PD,1,0,0,1
ORANGE COUNTY,COSTA MESA PD,124,4,21,149
ORANGE COUNTY,CSU FULLERTON PD,30,0,8,38
ORANGE COUNTY,CYPRESS PD,50,0,0,50
ORANGE COUNTY,FOUNTAIN VALLEY PD,53,0,10,63
ORANGE COUNTY,FULLERTON PD,136,4,18,158
ORANGE COUNTY,GARDEN GROVE PD,164,21,18,203
ORANGE COUNTY,HUNTINGTON BEACH PD,204,9,29,242
ORANGE COUNTY,IRVINE PD,216,3,17,236
ORANGE COUNTY,IRVINE VALLEY CCD PD,7,0,5,12
ORANGE COUNTY,LA HABRA PD,62,4,15,81
ORANGE COUNTY,LA PALMA PD,18,3,8,29
ORANGE COUNTY,LAGUNA BEACH PD,47,5,11,63
ORANGE COUNTY,LOS ALAMITOS PD,22,2,0,24
ORANGE COUNTY,NEWPORT BEACH PD,135,8,21,164
ORANGE COUNTY,ORANGE CO DA,171,0,0,171
ORANGE COUNTY,ORANGE CO SD/CORONER,1916,180,57,2153
ORANGE COUNTY,ORANGE PD,147,8,19,174
ORANGE COUNTY,PLACENTIA PD,43,4,10,57
ORANGE COUNTY,SADDLEBACK CCD PD,6,0,2,8
ORANGE COUNTY,SANTA ANA PD,308,5,32,345
ORANGE COUNTY,SANTA ANA UNIF SCHL DIST PD,20,0,0,20
ORANGE COUNTY,SEAL BEACH PD,33,3,0,36
ORANGE COUNTY,TUSTIN PD,88,9,13,110
ORANGE COUNTY,UC IRVINE PD,38,0,8,46
ORANGE COUNTY,WEST CITIES COMM CTR,0,0,24,24
ORANGE COUNTY,WESTMINSTER PD,74,4,12,90
PLACER COUNTY,AUBURN PD,19,3,7,29
PLACER COUNTY,LINCOLN PD,22,0,5,27
PLACER COUNTY,PLACER CO DA,19,0,0,19
PLACER COUNTY,PLACER COUNTY SD,250,81,26,357
PLACER COUNTY,ROCKLIN PD,52,6,14,72
PLACER COUNTY,ROSEVILLE PD,123,3,24,150
PLACER COUNTY,UNION PACIFIC RAILROAD,50,0,0,50
PLUMAS COUNTY,PLUMAS CO SD,32,8,9,49
RIVERSIDE COUNTY,BANNING PD,26,2,8,36
RIVERSIDE COUNTY,BEAUMONT PD,42,0,9,51
RIVERSIDE COUNTY,BLYTHE PD,21,0,7,28
RIVERSIDE COUNTY,CATHEDRAL CITY PD,50,9,18,77
RIVERSIDE COUNTY,CORONA PD,154,0,23,177
RIVERSIDE COUNTY,DESERT HOT SPRINGS PD,32,1,0,33
RIVERSIDE COUNTY,HEMET PD,75,0,17,92
RIVERSIDE COUNTY,INDIO PD,62,0,15,77
RIVERSIDE COUNTY,MURRIETA PD,87,4,20,111
RIVERSIDE COUNTY,PALM SPRINGS PD,93,4,14,111
RIVERSIDE COUNTY,RIVERSIDE CCD PD,21,5,0,26
RIVERSIDE COUNTY,RIVERSIDE CO DA,110,0,2,112
RIVERSIDE COUNTY,RIVERSIDE CO PUBLIC SOCIAL SER,18,0,0,18
RIVERSIDE COUNTY,RIVERSIDE CO SD,1844,36,166,2046
RIVERSIDE COUNTY,RIVERSIDE PD,343,1,49,393
RIVERSIDE COUNTY,UC RIVERSIDE PD,32,0,8,40
SACRAMENTO COUNTY,CA ALCOHOLIC BEVERAGE CONTROL,195,0,0,195
SACRAMENTO COUNTY,CA ASSEMBLY SGT AT ARMS LEGIS,27,0,0,27
SACRAMENTO COUNTY,CA DEPT CONSUMER AFF DEN BD,16,0,0,16
SACRAMENTO COUNTY,CA DEPT CONSUMER AFF INVEST,119,0,0,119
SACRAMENTO COUNTY,CA DEPT DEVELOPMENTAL OPS,83,0,0,83
SACRAMENTO COUNTY,CA DEPT EMPLOYMENT DEVELOPMENT,37,0,0,37
SACRAMENTO COUNTY,CA DEPT FISH & WILDLIFE,366,0,0,366
SACRAMENTO COUNTY,CA DEPT HEALTH CARE SVCS,84,0,0,84
SACRAMENTO COUNTY,CA DEPT INSURANCE FRAUD,180,0,0,180
SACRAMENTO COUNTY,CA DEPT JUSTICE,281,0,0,281
SACRAMENTO COUNTY,CA DEPT MOTOR VEHICLES,194,0,0,194
SACRAMENTO COUNTY,CA DEPT OF MANAGED HEALTH CARE,1,0,0,1
SACRAMENTO COUNTY,CA DEPT PARKS & RECREATION,520,0,51,571
SACRAMENTO COUNTY,CA DEPT PUB HEALTH FOOD/DRUG,102,0,0,102
SACRAMENTO COUNTY,CA DEPT SOCIAL SERVICES,49,0,0,49
SACRAMENTO COUNTY,CA DEPT STATE HOSPITALS,37,0,0,37
SACRAMENTO COUNTY,CA DEPT TOXIC SUBSTANCES CNTL,12,0,0,12
SACRAMENTO COUNTY,CA FRANCHISE TAX BOARD,41,0,0,41
SACRAMENTO COUNTY,CA HIGHWAY PATROL,7328,0,856,8184
SACRAMENTO COUNTY,CA HORSE RACING BOARD,7,0,0,7
SACRAMENTO COUNTY,CA SECRETARY OF STATE OFC INV,5,0,0,5
SACRAMENTO COUNTY,CA STATE FAIR PD,4,1,0,5
SACRAMENTO COUNTY,CA STATE LOTTERY,30,0,0,30
SACRAMENTO COUNTY,CAL - OES,12,0,0,12
SACRAMENTO COUNTY,CAL FIRE,188,0,0,188
SACRAMENTO COUNTY,CITRUS HEIGHTS PD,86,6,22,114
SACRAMENTO COUNTY,CSU SACRAMENTO UNIVERSITY PD,21,0,5,26
SACRAMENTO COUNTY,ELK GROVE PD,139,0,23,162
SACRAMENTO COUNTY,FOLSOM PD,72,4,17,93
SACRAMENTO COUNTY,GALT PD,32,2,10,44
SACRAMENTO COUNTY,LOS RIOS CCD PD,21,1,5,27
SACRAMENTO COUNTY,SACRAMENTO CO CORONER,14,0,0,14
SACRAMENTO COUNTY,SACRAMENTO CO DA,44,0,0,44
SACRAMENTO COUNTY,SACRAMENTO CO HUMAN ASST INV,24,0,0,24
SACRAMENTO COUNTY,SACRAMENTO CO REG PARKS DEPT,26,2,0,28
SACRAMENTO COUNTY,SACRAMENTO CO SD,1313,394,65,1772
SACRAMENTO COUNTY,SACRAMENTO PD,660,101,88,849
SACRAMENTO COUNTY,TWIN RIVERS USD PD,22,4,5,31
SAN BENITO COUNTY,HOLLISTER PD,31,1,0,32
SAN BENITO COUNTY,SAN BENITO CO DA,2,0,0,2
SAN BENITO COUNTY,SAN BENITO CO SD,53,7,0,60
SAN BERNARDINO COUNTY,BARSTOW PD,37,1,12,50
SAN BERNARDINO COUNTY,BURLINGTON NORTHRN SANTA FE RR,34,0,0,34
SAN BERNARDINO COUNTY,CHAFFEY CCD PD,12,0,0,12
SAN BERNARDINO COUNTY,COLTON PD,51,0,12,63
SAN BERNARDINO COUNTY,CSU SAN BERNARDINO DPS,18,0,10,28
SAN BERNARDINO COUNTY,FONTANA PD,177,1,27,205
SAN BERNARDINO COUNTY,FONTANA UNIFIED SCHOOL DIST,16,0,10,26
SAN BERNARDINO COUNTY,HESPERIA UNIFIED SCHOOL DIST,8,0,0,8
SAN BERNARDINO COUNTY,MONTCLAIR PD,43,6,10,59
SAN BERNARDINO COUNTY,ONTARIO PD,267,9,44,320
SAN BERNARDINO COUNTY,REDLANDS PD,78,3,15,96
SAN BERNARDINO COUNTY,RIALTO PD,104,1,11,116
SAN BERNARDINO COUNTY,SAN BERNARDINO CCD PD,7,0,2,9
SAN BERNARDINO COUNTY,SAN BERNARDINO CO DA,52,0,0,52
SAN BERNARDINO COUNTY,SAN BERNARDINO CO SD,2052,174,167,2393
SAN BERNARDINO COUNTY,SAN BERNARDINO PD,243,17,34,294
SAN BERNARDINO COUNTY,SAN BERNARDINO UNIF SCHL DIST,26,6,7,39
SAN BERNARDINO COUNTY,SNOWLINE JOINT UNIF SCHL DIST,3,2,0,5
SAN BERNARDINO COUNTY,UPLAND PD,62,5,16,83
SAN BERNARDINO COUNTY,VICTOR VALLEY COLLEGE PD,4,4,0,8
SAN DIEGO COUNTY,CARLSBAD PD,113,3,19,135
SAN DIEGO COUNTY,CHULA VISTA PD,220,4,24,248
SAN DIEGO COUNTY,CORONADO PD,43,1,7,51
SAN DIEGO COUNTY,CSU SAN DIEGO DPS,27,0,9,36
SAN DIEGO COUNTY,CSU SAN MARCOS DPS,19,0,7,26
SAN DIEGO COUNTY,EL CAJON PD,112,24,19,155
SAN DIEGO COUNTY,ESCONDIDO PD,155,10,24,189
SAN DIEGO COUNTY,LA MESA PD,67,2,20,89
SAN DIEGO COUNTY,MIRA COSTA CCD PD,9,0,4,13
SAN DIEGO COUNTY,NATIONAL CITY PD,86,6,15,107
SAN DIEGO COUNTY,OCEANSIDE PD,207,1,26,234
SAN DIEGO COUNTY,PALOMAR CCD PD,9,2,0,11
SAN DIEGO COUNTY,SAN DIEGO CCD PD,35,0,9,44
SAN DIEGO COUNTY,SAN DIEGO CITY SCHOOLS PD,38,0,8,46
SAN DIEGO COUNTY,SAN DIEGO CO DA,125,1,0,126
SAN DIEGO COUNTY,SAN DIEGO CO SD,2685,76,151,2912
SAN DIEGO COUNTY,"SAN DIEGO HARBOR PD, PORT OF",127,0,13,140
SAN DIEGO COUNTY,SAN DIEGO PD,1748,64,175,1987
SAN DIEGO COUNTY,SOUTHWESTERN CCD PD,10,0,0,10
SAN DIEGO COUNTY,UC SAN DIEGO PD,37,0,9,46
SAN FRANCISCO COUNTY,CSU SAN FRANCISCO PD,27,0,4,31
SAN FRANCISCO COUNTY,SAN FRAN INT'L AIRPORT COMM,0,0,35,35
SAN FRANCISCO COUNTY,SAN FRANCISCO CCD PD,25,0,1,26
SAN FRANCISCO COUNTY,SAN FRANCISCO CO DA,35,0,0,35
SAN FRANCISCO COUNTY,SAN FRANCISCO CO MED EXAM,12,0,0,12
SAN FRANCISCO COUNTY,SAN FRANCISCO CO SD,822,0,0,822
SAN FRANCISCO COUNTY,SAN FRANCISCO DEPT EMER MGT,0,0,211,211
SAN FRANCISCO COUNTY,SAN FRANCISCO PD,2245,33,0,2278
SAN FRANCISCO COUNTY,SUPREME COURT OF CALIFORNIA,1,0,0,1
SAN FRANCISCO COUNTY,UC SAN FRANCISCO PD,50,0,12,62
SAN JOAQUIN COUNTY,ESCALON PD,9,12,0,21
SAN JOAQUIN COUNTY,LODI PD,66,5,17,88
SAN JOAQUIN COUNTY,MANTECA PD,60,6,11,77
SAN JOAQUIN COUNTY,RIPON PD,22,1,3,26
SAN JOAQUIN COUNTY,SAN JOAQUIN CO DA,32,0,0,32
SAN JOAQUIN COUNTY,SAN JOAQUIN CO SD,316,6,30,352
SAN JOAQUIN COUNTY,SAN JOAQUIN DELTA COLLEGE PD,11,1,7,19
SAN JOAQUIN COUNTY,STOCKTON PD,433,35,53,521
SAN JOAQUIN COUNTY,STOCKTON UNIF SCHL DIST PD,29,1,8,38
SAN JOAQUIN COUNTY,TRACY PD,86,0,14,100
SAN LUIS OBISPO COUNTY,ARROYO GRANDE PD,23,2,0,25
SAN LUIS OBISPO COUNTY,ATASCADERO PD,28,0,6,34
SAN LUIS OBISPO COUNTY,CPSU SAN LUIS OBISPO PD,19,0,8,27
SAN LUIS OBISPO COUNTY,CUESTA CCD DPS,7,0,0,7
SAN LUIS OBISPO COUNTY,GROVER BEACH PD,18,1,7,26
SAN LUIS OBISPO COUNTY,MORRO BAY PD,17,0,0,17
SAN LUIS OBISPO COUNTY,PASO ROBLES PD,33,3,9,45
SAN LUIS OBISPO COUNTY,PISMO BEACH PD,22,1,7,30
SAN LUIS OBISPO COUNTY,SAN LUIS OBISPO CO DA,13,0,0,13
SAN LUIS OBISPO COUNTY,SAN LUIS OBISPO CO SD,286,10,21,317
SAN LUIS OBISPO COUNTY,SAN LUIS OBISPO PD,55,1,12,68
SAN MATEO COUNTY,ATHERTON PD,19,4,10,33
SAN MATEO COUNTY,BELMONT PD,29,1,9,39
SAN MATEO COUNTY,BRISBANE PD,15,0,0,15
SAN MATEO COUNTY,BROADMOOR PD,9,18,0,27
SAN MATEO COUNTY,BURLINGAME PD,38,2,15,55
SAN MATEO COUNTY,COLMA PD,19,0,5,24
SAN MATEO COUNTY,DALY CITY PD,98,0,1,99
SAN MATEO COUNTY,EAST PALO ALTO PD,36,0,0,36
SAN MATEO COUNTY,FOSTER CITY PD,35,3,11,49
SAN MATEO COUNTY,HILLSBOROUGH PD,27,1,6,34
SAN MATEO COUNTY,MENLO PARK PD,44,2,14,60
SAN MATEO COUNTY,PACIFICA PD,32,5,0,37
SAN MATEO COUNTY,REDWOOD CITY PD,86,5,20,111
SAN MATEO COUNTY,SAN BRUNO PD,47,7,8,62
SAN MATEO COUNTY,SAN MATEO CO CORONER,9,0,0,9
SAN MATEO COUNTY,SAN MATEO CO DA,16,0,0,16
SAN MATEO COUNTY,SAN MATEO CO PUB SFTY COMM CTR,0,0,70,70
SAN MATEO COUNTY,SAN MATEO CO SD,334,46,0,380
SAN MATEO COUNTY,SAN MATEO PD,106,5,24,135
SAN MATEO COUNTY,SOUTH SAN FRANCISCO PD,80,6,17,103
SANTA BARBARA COUNTY,ALLAN HANCOCK CCD PD,3,1,1,5
SANTA BARBARA COUNTY,GUADALUPE PD,12,1,0,13
SANTA BARBARA COUNTY,LOMPOC PD,45,1,7,53
SANTA BARBARA COUNTY,SANTA BARBARA CO DA,14,0,0,14
SANTA BARBARA COUNTY,SANTA BARBARA CO SD,451,33,32,516
SANTA BARBARA COUNTY,SANTA BARBARA PD,133,11,19,163
SANTA BARBARA COUNTY,SANTA MARIA PD,118,1,19,138
SANTA BARBARA COUNTY,UC SANTA BARBARA PD,41,0,7,48
SANTA CLARA COUNTY,CAMPBELL PD,44,11,12,67
SANTA CLARA COUNTY,CSU SAN JOSE PD,31,1,7,39
SANTA CLARA COUNTY,FOOTHILL-DEANZA CCD PD,14,0,0,14
SANTA CLARA COUNTY,GILROY PD,61,5,12,78
SANTA CLARA COUNTY,LOS ALTOS PD,30,3,9,42
SANTA CLARA COUNTY,LOS GATOS PD,37,7,7,51
SANTA CLARA COUNTY,MILPITAS PD,81,0,13,94
SANTA CLARA COUNTY,MORGAN HILL PD,39,3,10,52
SANTA CLARA COUNTY,MOUNTAIN VIEW EMERG COMM (OBS),0,0,15,15
SANTA CLARA COUNTY,MOUNTAIN VIEW PD,88,13,0,101
SANTA CLARA COUNTY,PALO ALTO PD,76,6,20,102
SANTA CLARA COUNTY,SAN JOSE PD,914,85,151,1150
SANTA CLARA COUNTY,SAN JOSE UNIF SCHL DIST PD,1,0,0,1
SANTA CLARA COUNTY,SAN JOSE/EVERGREEN CCD PD,7,5,0,12
SANTA CLARA COUNTY,SANTA CLARA CO COMM DEPT,0,0,83,83
SANTA CLARA COUNTY,SANTA CLARA CO DA,80,0,0,80
SANTA CLARA COUNTY,SANTA CLARA CO DA-WELFARE FRD,1,0,0,1
SANTA CLARA COUNTY,SANTA CLARA CO SD,1196,62,0,1258
SANTA CLARA COUNTY,SANTA CLARA PD,145,163,26,334
SANTA CLARA COUNTY,SUNNYVALE DPS,194,0,21,215
SANTA CLARA COUNTY,WEST VALLEY CCD PD,8,1,0,9
SANTA CRUZ COUNTY,CAPITOLA PD,20,2,0,22
SANTA CRUZ COUNTY,SANTA CRUZ CO DA,13,0,0,13
SANTA CRUZ COUNTY,SANTA CRUZ CO SD,142,16,0,158
SANTA CRUZ COUNTY,SANTA CRUZ PD,87,1,0,88
SANTA CRUZ COUNTY,SCOTTS VALLEY PD,17,6,6,29
SANTA CRUZ COUNTY,UC SANTA CRUZ PD,20,0,9,29
SANTA CRUZ COUNTY,WATSONVILLE PD,63,1,0,64
SHASTA COUNTY,ANDERSON PD,20,0,0,20
SHASTA COUNTY,REDDING PD,104,1,0,105
SHASTA COUNTY,SHASTA AREA SAFETY COMM AGCY,0,0,38,38
SHASTA COUNTY,SHASTA CO DA,12,0,0,12
SHASTA COUNTY,SHASTA CO MARSHAL,22,0,2,24
SHASTA COUNTY,SHASTA CO SD,127,5,0,132
SIERRA COUNTY,SIERRA CO SHERIFF'S OFFICE,8,2,0,10
SISKIYOU COUNTY,ETNA PD,2,3,0,5
SISKIYOU COUNTY,LAKE SHASTINA DISTRICT PD,5,0,0,5
SISKIYOU COUNTY,MOUNT SHASTA PD,8,2,3,13
SISKIYOU COUNTY,SISKIYOU CO DA,3,0,0,3
SISKIYOU COUNTY,SISKIYOU CO SD,64,4,9,77
SISKIYOU COUNTY,TULELAKE PD,2,0,0,2
SISKIYOU COUNTY,WEED PD,9,2,6,17
SISKIYOU COUNTY,YREKA PD,14,0,6,20
SOLANO COUNTY,BENICIA PD,32,1,17,50
SOLANO COUNTY,CSU CAL MARITIME ACADEMY PD,10,0,0,10
SOLANO COUNTY,DIXON PD,24,0,0,24
SOLANO COUNTY,FAIRFIELD PD,112,0,25,137
SOLANO COUNTY,RIO VISTA PD,10,2,0,12
SOLANO COUNTY,SOLANO CO DA,12,0,0,12
SOLANO COUNTY,SOLANO CO SD,154,11,18,183
SOLANO COUNTY,SOLANO CO SPECIAL INV BUREAU,8,0,0,8
SOLANO COUNTY,SUISUN CITY PD,25,3,7,35
SOLANO COUNTY,VACAVILLE PD,103,3,19,125
SOLANO COUNTY,VALLEJO PD,109,3,21,133
SONOMA COUNTY,CLOVERDALE PD,13,1,7,21
SONOMA COUNTY,COTATI PD,10,0,6,16
SONOMA COUNTY,CSU SONOMA PD,14,0,4,18
SONOMA COUNTY,HEALDSBURG PD,18,0,6,24
SONOMA COUNTY,PETALUMA PD,61,0,14,75
SONOMA COUNTY,ROHNERT PARK DPS,62,0,12,74
SONOMA COUNTY,SANTA ROSA PD,171,0,30,201
SONOMA COUNTY,SEBASTOPOL PD,14,9,6,29
SONOMA COUNTY,SONOMA CO DA,13,0,0,13
SONOMA COUNTY,"SONOMA CO HUM SRV,WLF FRD INV",6,0,0,6
SONOMA COUNTY,SONOMA CO JR COLLEGE DIST PD,13,0,7,20
SONOMA COUNTY,SONOMA CO SHERIFF'S OFFICE,447,1,28,476
SONOMA COUNTY,SONOMA-MARIN AREA RAIL TRANSIT,1,0,0,1
STANISLAUS COUNTY,CERES DPS,46,2,9,57
STANISLAUS COUNTY,CSU STANISLAUS DPS,11,0,2,13
STANISLAUS COUNTY,MODESTO PD,209,15,0,224
STANISLAUS COUNTY,NEWMAN PD,11,4,0,15
STANISLAUS COUNTY,OAKDALE PD,22,6,9,37
STANISLAUS COUNTY,STANISLAUS CO DA,17,0,0,17
STANISLAUS COUNTY,STANISLAUS CO SD,489,30,1,520
STANISLAUS COUNTY,STANISLAUS REGIONAL 9-1-1,1,0,52,53
STANISLAUS COUNTY,TURLOCK PD,74,0,13,87
SUTTER COUNTY,SUTTER CO DA,7,0,0,7
SUTTER COUNTY,SUTTER CO SD,105,23,12,140
SUTTER COUNTY,YUBA CITY PD,56,4,10,70
SUTTER COUNTY,CORNING PD,13,0,5,18
SUTTER COUNTY,RED BLUFF PD,26,0,7,33
SUTTER COUNTY,TEHAMA CO DA,7,0,0,7
SUTTER COUNTY,TEHAMA CO SD,90,5,9,104
TRINITY COUNTY,TRINITY CO DIST ATTORNEY,1,0,0,1
TRINITY COUNTY,TRINITY CO MARSHAL,3,0,0,3
TRINITY COUNTY,TRINITY COUNTY SD,19,5,2,26
TULARE COUNTY,COLLEGE OF THE SEQUOIAS PD,6,2,0,8
TULARE COUNTY,DINUBA PD,36,3,6,45
TULARE COUNTY,EXETER PD,16,5,1,22
TULARE COUNTY,FARMERSVILLE PD,12,0,1,13
TULARE COUNTY,LINDSAY DPS,15,5,4,24
TULARE COUNTY,PORTERVILLE PD,54,4,14,72
TULARE COUNTY,TULARE CO DA,40,0,0,40
TULARE COUNTY,TULARE CO SD,534,25,28,587
TULARE COUNTY,TULARE PD,72,0,13,85
TULARE COUNTY,VISALIA PD,140,2,24,166
TULARE COUNTY,WOODLAKE PD,11,0,0,11
TUOLUMNE COUNTY,SONORA PD,10,0,6,16
TUOLUMNE COUNTY,TUOLUMNE CO DA,2,0,0,2
TUOLUMNE COUNTY,TUOLUMNE CO SD,102,7,14,123
VENTURA COUNTY,CSU CHANNEL ISLANDS PD,13,0,6,19
VENTURA COUNTY,OXNARD PD,221,8,20,249
VENTURA COUNTY,PORT HUENEME PD,22,5,5,32
VENTURA COUNTY,SANTA PAULA PD,31,16,6,53
VENTURA COUNTY,SIMI VALLEY PD,121,2,16,139
VENTURA COUNTY,VENTURA CO CCD PD,16,1,0,17
VENTURA COUNTY,VENTURA CO DA,47,0,0,47
VENTURA COUNTY,VENTURA CO SD,731,14,39,784
VENTURA COUNTY,VENTURA PD,128,0,14,142
YOLO COUNTY,DAVIS PD,56,1,14,71
YOLO COUNTY,UC DAVIS PD,46,0,9,55
YOLO COUNTY,WEST SACRAMENTO PD,70,4,0,74
YOLO COUNTY,WINTERS PD,11,2,1,14
YOLO COUNTY,WOODLAND PD,64,0,0,64
YOLO COUNTY,YOLO CO COMM EMER,0,0,32,32
YOLO COUNTY,YOLO CO DA,14,0,0,14
YOLO COUNTY,YOLO CO SD,86,6,0,92
YUBA COUNTY,MARYSVILLE PD,17,11,8,36
YUBA COUNTY,WHEATLAND PD,7,4,0,11
YUBA COUNTY,YUBA CO DA,2,0,0,2
YUBA COUNTY,YUBA CO SD,63,24,10,97
YUBA COUNTY,YUBA COMMUNITY COLL DIST PD,4,0,0,4
YUBA COUNTY,** GRAND TOTAL,83531,4550,7992,96073
