County,Agency,Sworn,Reserve,Dispatcher,Total
ALAMEDA COUNTY,ALAMEDA CO SD/CORONER,943,19,34,996
ALAMEDA COUNTY,ALAMEDA PD,78,0,17,95
ALAMEDA COUNTY,ALBANY PD,23,2,7,32
ALAMEDA COUNTY,AMTRAK PD,31,0,0,31
ALAMEDA COUNTY,BAY AREA RAPID TRANSIT PD,180,0,16,196
ALAMEDA COUNTY,BERKELEY PD,155,17,31,203
ALAMEDA COUNTY,CSU EAST BAY PD,13,0,3,16
ALAMEDA COUNTY,EAST BAY REG PARK DPS,60,3,14,77
ALAMEDA COUNTY,EMERYVILLE PD,37,0,12,49
ALAMEDA COUNTY,FREMONT PD,182,5,30,217
ALAMEDA COUNTY,HAYWARD PD,178,24,30,232
ALAMEDA COUNTY,LIVERMORE PD,89,5,21,115
ALAMEDA COUNTY,NEWARK PD,52,2,13,67
ALAMEDA COUNTY,OAKLAND CITY HOUSING AUTH PD,27,1,0,28
ALAMEDA COUNTY,OAKLAND PD,771,5,70,846
ALAMEDA COUNTY,OAKLAND USD PD,11,0,0,11
ALAMEDA COUNTY,OHLONE CCD PD,2,1,0,3
ALAMEDA COUNTY,PIEDMONT PD,20,6,7,33
ALAMEDA COUNTY,PLEASANTON PD,80,1,17,98
ALAMEDA COUNTY,SAN LEANDRO PD,90,0,16,106
ALAMEDA COUNTY,UC BERKELEY PD,50,0,9,59
ALAMEDA COUNTY,UNION CITY PD,76,0,1,77
ALPINE COUNTY,ALPINE CO SD,13,1,1,15
AMADOR COUNTY,AMADOR CO DA,7,0,0,7
AMADOR COUNTY,AMADOR CO SD/CORONER,43,2,13,58
AMADOR COUNTY,IONE PD,8,1,0,9
AMADOR COUNTY,JACKSON PD,8,6,0,14
AMADOR COUNTY,SUTTER CREEK PD,5,3,0,8
BUTTE COUNTY,BUTTE CCD PD,5,0,0,5
BUTTE COUNTY,BUTTE CO DA,19,0,0,19
BUTTE COUNTY,BUTTE CO SD/CORONER,169,30,15,214
BUTTE COUNTY,CHICO PD,101,0,23,124
BUTTE COUNTY,CSU CHICO PD,18,0,5,23
BUTTE COUNTY,GRIDLEY PD,11,5,8,24
BUTTE COUNTY,OROVILLE PD,21,5,8,34
BUTTE COUNTY,PARADISE PD,17,0,8,25
CALAVERAS COUNTY,ANGELS CAMP PD,6,0,0,6
CALAVERAS COUNTY,CALAVERAS CO DA,1,0,0,1
CALAVERAS COUNTY,CALAVERAS CO SD,54,4,11,69
COLUSA COUNTY,COLUSA CO DISTRICT ATTORNEY,4,0,0,4
COLUSA COUNTY,COLUSA COUNTY SD,30,1,7,38
COLUSA COUNTY,COLUSA PD,8,1,0,9
COLUSA COUNTY,WILLIAMS PD,11,0,0,11
CONTRA COSTA COUNTY,ANTIOCH PD,104,3,16,123
CONTRA COSTA COUNTY,BRENTWOOD PD,64,0,0,64
CONTRA COSTA COUNTY,CLAYTON PD,11,0,0,11
CONTRA COSTA COUNTY,CONCORD PD,149,8,17,174
CONTRA COSTA COUNTY,CONTRA COSTA CCD PD,22,0,0,22
CONTRA COSTA COUNTY,CONTRA COSTA CO DA,28,0,0,28
CONTRA COSTA COUNTY,CONTRA COSTA CO SD/CORONER,625,29,49,703
CONTRA COSTA COUNTY,EL CERRITO PD,39,2,0,41
CONTRA COSTA COUNTY,HERCULES PD,24,2,0,26
CONTRA COSTA COUNTY,KENSINGTON PD,7,0,0,7
CONTRA COSTA COUNTY,MARTINEZ PD,31,5,7,43
CONTRA COSTA COUNTY,MORAGA PD,12,4,0,16
CONTRA COSTA COUNTY,OAKLEY PD,33,0,0,33
CONTRA COSTA COUNTY,PINOLE PD,26,0,12,38
CONTRA COSTA COUNTY,PITTSBURG PD,82,0,0,82
CONTRA COSTA COUNTY,PLEASANT HILL PD,42,1,7,50
CONTRA COSTA COUNTY,RICHMOND PD,159,3,17,179
CONTRA COSTA COUNTY,SAN PABLO PD,59,0,0,59
CONTRA COSTA COUNTY,SAN RAMON PD,66,0,0,66
CONTRA COSTA COUNTY,WALNUT CREEK PD,81,28,15,124
DEL NORTE COUNTY,CRESCENT CITY PD,12,2,0,14
DEL NORTE COUNTY,DEL NORTE CO DA,2,0,0,2
DEL NORTE COUNTY,DEL NORTE COUNTY SD,19,5,5,29
EL DORADO COUNTY,EL DORADO CO DA,17,0,0,17
EL DORADO COUNTY,EL DORADO CO SD,154,4,18,176
EL DORADO COUNTY,PLACERVILLE PD,19,1,3,23
EL DORADO COUNTY,SOUTH LAKE TAHOE PD,36,5,9,50
FRESNO COUNTY,CLOVIS PD,102,11,25,138
FRESNO COUNTY,CLOVIS UNIF SCHL DIST PD,16,0,0,16
FRESNO COUNTY,COALINGA PD,14,1,6,21
FRESNO COUNTY,CSU FRESNO DPS,27,0,7,34
FRESNO COUNTY,FIREBAUGH PD,10,7,0,17
FRESNO COUNTY,FOWLER PD,11,4,0,15
FRESNO COUNTY,FRESNO CO DA,53,0,0,53
FRESNO COUNTY,FRESNO CO SD,416,75,46,537
FRESNO COUNTY,FRESNO PD,820,23,101,944
FRESNO COUNTY,FRESNO YOSEMITE INT'L AIRPORT,6,0,0,6
FRESNO COUNTY,HURON PD,11,4,6,21
FRESNO COUNTY,KERMAN PD,21,8,0,29
FRESNO COUNTY,KINGSBURG PD,17,8,0,25
FRESNO COUNTY,MENDOTA PD,14,7,0,21
FRESNO COUNTY,ORANGE COVE PD,11,3,0,14
FRESNO COUNTY,PARLIER PD,19,0,0,19
FRESNO COUNTY,REEDLEY PD,27,3,7,37
FRESNO COUNTY,SANGER PD,37,1,0,38
FRESNO COUNTY,SELMA PD,35,1,7,43
FRESNO COUNTY,STATE CENTER CCD PD,19,0,5,24
GLENN COUNTY,GLENN CO DA,1,0,0,1
GLENN COUNTY,GLENN CO SD/CORONER,45,4,7,56
GLENN COUNTY,ORLAND PD,12,0,0,12
HUMBOLDT COUNTY,ARCATA PD,27,3,8,38
HUMBOLDT COUNTY,CSU HUMBOLDT DPS,12,0,7,19
HUMBOLDT COUNTY,EUREKA PD,45,2,10,57
HUMBOLDT COUNTY,FERNDALE PD,6,0,0,6
HUMBOLDT COUNTY,FORTUNA PD,18,1,8,27
HUMBOLDT COUNTY,HUMBOLDT CO DA,9,0,0,9
HUMBOLDT COUNTY,HUMBOLDT CO SD,188,11,10,209
HUMBOLDT COUNTY,HUMBOLDT DEPT WELFARE/INVEST,8,0,0,8
HUMBOLDT COUNTY,RIO DELL PD,6,1,0,7
IMPERIAL COUNTY,BRAWLEY PD,30,4,7,41
IMPERIAL COUNTY,CALEXICO PD,19,4,6,29
IMPERIAL COUNTY,CALIPATRIA PD,6,2,0,8
IMPERIAL COUNTY,EL CENTRO PD,46,1,11,58
IMPERIAL COUNTY,IMPERIAL CO DA,17,0,0,17
IMPERIAL COUNTY,IMPERIAL CO SD,94,10,14,118
IMPERIAL COUNTY,IMPERIAL PD,16,1,0,17
IMPERIAL COUNTY,WESTMORLAND PD,6,4,0,10
INYO COUNTY,BISHOP PD,12,4,7,23
INYO COUNTY,INYO CO DA,2,0,0,2
INYO COUNTY,INYO COUNTY SD,36,19,5,60
KERN COUNTY,ARVIN PD,15,3,5,23
KERN COUNTY,BAKERSFIELD PD,389,8,36,433
KERN COUNTY,BEAR VALLEY PD,5,0,0,5
KERN COUNTY,CALIFORNIA CITY PD,11,7,6,24
KERN COUNTY,CSU BAKERSFIELD DPS,12,0,7,19
KERN COUNTY,DELANO PD,52,2,8,62
KERN COUNTY,KERN CO DA,27,0,0,27
KERN COUNTY,KERN CO-DEPT OF PARKS & REC,5,1,0,6
KERN COUNTY,KERN COUNTY SD,832,56,42,930
KERN COUNTY,KERN HIGH SCHOOL DISTRICT PD,27,0,0,27
KERN COUNTY,MCFARLAND PD,11,2,5,18
KERN COUNTY,RIDGECREST PD,29,11,6,46
KERN COUNTY,SHAFTER PD,22,0,7,29
KERN COUNTY,STALLION SPRINGS PD,3,0,0,3
KERN COUNTY,TAFT PD,14,2,4,20
KERN COUNTY,TEHACHAPI PD,17,1,8,26
KINGS COUNTY,AVENAL PD,18,1,0,19
KINGS COUNTY,CORCORAN PD,17,3,6,26
KINGS COUNTY,HANFORD PD,56,0,16,72
KINGS COUNTY,KINGS CO DA,14,0,0,14
KINGS COUNTY,KINGS CO SHERIFF'S OFFICE,191,7,16,214
KINGS COUNTY,"KINGS CO-HUMAN SVCS,WELFARE FD",5,0,0,5
KINGS COUNTY,LEMOORE PD,33,8,0,41
LAKE COUNTY,CLEARLAKE PD,23,2,8,33
LAKE COUNTY,LAKE CO DA,5,0,1,6
LAKE COUNTY,LAKE CO SD,47,1,7,55
LAKE COUNTY,LAKEPORT PD,11,1,0,12
LASSEN COUNTY,LASSEN CO DA,1,0,0,1
LASSEN COUNTY,LASSEN CO SD,56,3,9,68
LASSEN COUNTY,SUSANVILLE PD,15,0,0,15
LOS ANGELES COUNTY,ALHAMBRA PD,78,4,12,94
LOS ANGELES COUNTY,ARCADIA PD,70,6,9,85
LOS ANGELES COUNTY,AZUSA PD,57,3,9,69
LOS ANGELES COUNTY,BALDWIN PARK PD,66,1,12,79
LOS ANGELES COUNTY,BALDWIN PARK UNIF SCH DIST PD,9,0,0,9
LOS ANGELES COUNTY,BELL GARDENS PD,50,0,6,56
LOS ANGELES COUNTY,BELL PD,32,3,5,40
LOS ANGELES COUNTY,BEVERLY HILLS PD,128,8,20,156
LOS ANGELES COUNTY,BURBANK AIRPORT AUTH PD,33,0,0,33
LOS ANGELES COUNTY,BURBANK PD,140,12,16,168
LOS ANGELES COUNTY,CA DEPT INDUSTRIAL RELATIONS,3,0,0,3
LOS ANGELES COUNTY,CA DEPT OF BUSINESS OVERSIGHT,3,0,0,3
LOS ANGELES COUNTY,CERRITOS CCD PD,14,0,0,14
LOS ANGELES COUNTY,CLAREMONT PD,38,4,7,49
LOS ANGELES COUNTY,COMPTON UNIF SCH DIST PD,19,0,0,19
LOS ANGELES COUNTY,COVINA PD,55,1,12,68
LOS ANGELES COUNTY,CSU DOMINGUEZ HILLS PD,19,0,7,26
LOS ANGELES COUNTY,CSU LONG BEACH PD,23,0,12,35
LOS ANGELES COUNTY,CSU LOS ANGELES DPS,22,0,6,28
LOS ANGELES COUNTY,CSU NORTHRIDGE DEPT POLICE SVS,21,0,5,26
LOS ANGELES COUNTY,CSU POMONA DPS,20,0,6,26
LOS ANGELES COUNTY,CULVER CITY PD,100,15,0,115
LOS ANGELES COUNTY,DOWNEY PD,118,0,15,133
LOS ANGELES COUNTY,EL CAMINO CCD PD,12,1,6,19
LOS ANGELES COUNTY,EL MONTE PD,118,23,15,156
LOS ANGELES COUNTY,EL SEGUNDO PD,53,0,0,53
LOS ANGELES COUNTY,GARDENA PD,93,5,0,98
LOS ANGELES COUNTY,GLENDALE CCD PD,9,0,0,9
LOS ANGELES COUNTY,GLENDALE PD,233,11,22,266
LOS ANGELES COUNTY,GLENDORA PD,52,3,11,66
LOS ANGELES COUNTY,HACIENDA LA PUENTE USD,5,0,0,5
LOS ANGELES COUNTY,HAWTHORNE PD,88,3,0,91
LOS ANGELES COUNTY,HERMOSA BEACH PD,35,1,0,36
LOS ANGELES COUNTY,HUNTINGTON PARK PD,55,6,8,69
LOS ANGELES COUNTY,INGLEWOOD PD,185,0,18,203
LOS ANGELES COUNTY,INGLEWOOD UNIF SCH DIST PD,5,3,0,8
LOS ANGELES COUNTY,IRWINDALE PD,27,3,6,36
LOS ANGELES COUNTY,LA VERNE PD,38,7,8,53
LOS ANGELES COUNTY,LONG BEACH PD,842,27,74,943
LOS ANGELES COUNTY,LOS ANGELES CITY PARK RANGER,23,0,0,23
LOS ANGELES COUNTY,LOS ANGELES CO CORONER,55,0,0,55
LOS ANGELES COUNTY,LOS ANGELES CO DA,248,0,0,248
LOS ANGELES COUNTY,LOS ANGELES CO SD,9463,586,510,10559
LOS ANGELES COUNTY,LOS ANGELES PD,9804,416,586,10806
LOS ANGELES COUNTY,LOS ANGELES PORT PD,129,0,10,139
LOS ANGELES COUNTY,LOS ANGELES SCHOOL PD,353,0,0,353
LOS ANGELES COUNTY,LOS ANGELES WORLD AIRPORTS PD,509,0,0,509
LOS ANGELES COUNTY,MANHATTAN BEACH PD,59,1,0,60
LOS ANGELES COUNTY,MONROVIA PD,47,2,11,60
LOS ANGELES COUNTY,MONTEBELLO PD,61,7,8,76
LOS ANGELES COUNTY,MONTEBELLO UNIFIED SCHOOL DIST,3,0,0,3
LOS ANGELES COUNTY,MONTEREY PARK PD,70,19,9,98
LOS ANGELES COUNTY,PALOS VERDES ESTATES PD,21,9,8,38
LOS ANGELES COUNTY,PASADENA CITY CCD PD,10,0,7,17
LOS ANGELES COUNTY,PASADENA PD,221,11,26,258
LOS ANGELES COUNTY,POMONA PD,150,11,31,192
LOS ANGELES COUNTY,REDONDO BEACH PD,91,15,13,119
LOS ANGELES COUNTY,SAN FERNANDO PD,28,17,8,53
LOS ANGELES COUNTY,SAN GABRIEL PD,52,3,5,60
LOS ANGELES COUNTY,SAN MARINO PD,25,0,5,30
LOS ANGELES COUNTY,SANTA MONICA CCD PD,17,0,6,23
LOS ANGELES COUNTY,SANTA MONICA OFFICE EMER MGT,0,0,27,27
LOS ANGELES COUNTY,SANTA MONICA PD,221,0,0,221
LOS ANGELES COUNTY,SIERRA MADRE PD,15,5,4,24
LOS ANGELES COUNTY,SIGNAL HILL PD,32,0,7,39
LOS ANGELES COUNTY,SOUTH BAY REG PUB COMM AUTH,0,0,63,63
LOS ANGELES COUNTY,SOUTH GATE PD,73,1,8,82
LOS ANGELES COUNTY,SOUTH PASADENA PD,32,4,5,41
LOS ANGELES COUNTY,TORRANCE PD,214,0,24,238
LOS ANGELES COUNTY,UC LOS ANGELES PD,56,0,14,70
LOS ANGELES COUNTY,VERNON PD,39,1,8,48
LOS ANGELES COUNTY,WEST COVINA PD,90,6,16,112
LOS ANGELES COUNTY,WHITTIER PD,115,1,13,129
MADERA COUNTY,CHOWCHILLA PD,17,2,9,28
MADERA COUNTY,MADERA CO DA,8,0,0,8
MADERA COUNTY,MADERA CO SD,87,22,10,119
MADERA COUNTY,MADERA PD,65,0,12,77
MARIN COUNTY,BELVEDERE PD,5,0,0,5
MARIN COUNTY,CENTRAL MARIN POLICE AUTHORITY,38,4,0,42
MARIN COUNTY,FAIRFAX PD,11,0,4,15
MARIN COUNTY,MARIN CCD PD,6,0,0,6
MARIN COUNTY,MARIN CO DA,13,0,0,13
MARIN COUNTY,MARIN CO HEALTH & HUMAN SVCS,4,0,0,4
MARIN COUNTY,MARIN CO SD,199,0,44,243
MARIN COUNTY,MARIN MUNCPL WATER DIST,6,0,0,6
MARIN COUNTY,MILL VALLEY PD,22,1,0,23
MARIN COUNTY,NOVATO PD,60,0,12,72
MARIN COUNTY,ROSS PD,8,2,0,10
MARIN COUNTY,SAN RAFAEL PD,65,3,18,86
MARIN COUNTY,SAUSALITO PD,18,0,0,18
MARIN COUNTY,TIBURON PD,15,7,0,22
MARIPOSA COUNTY,MARIPOSA CO DA,1,0,0,1
MARIPOSA COUNTY,MARIPOSA CO SD,60,16,0,76
MENDOCINO COUNTY,FORT BRAGG PD,13,0,0,13
MENDOCINO COUNTY,MENDOCINO CO DA,6,0,0,6
MENDOCINO COUNTY,MENDOCINO CO HEALTH/HUMAN SVCS,5,0,0,5
MENDOCINO COUNTY,MENDOCINO CO SD,129,5,15,149
MENDOCINO COUNTY,UKIAH PD,28,1,12,41
MENDOCINO COUNTY,WILLITS PD,12,1,6,19
MERCED COUNTY,ATWATER PD,24,2,5,31
MERCED COUNTY,DOS PALOS PD,8,2,4,14
MERCED COUNTY,GUSTINE PD,9,0,0,9
MERCED COUNTY,LIVINGSTON PD,20,3,7,30
MERCED COUNTY,LOS BANOS PD,39,2,11,52
MERCED COUNTY,MERCED CCD PD,5,0,0,5
MERCED COUNTY,MERCED CO DA,8,0,0,8
MERCED COUNTY,MERCED CO SD,125,42,14,181
MERCED COUNTY,MERCED PD,91,7,14,112
MERCED COUNTY,UC MERCED PD,15,0,5,20
MODOC COUNTY,ALTURAS PD,8,3,0,11
MODOC COUNTY,MODOC CO SD,11,0,6,17
MONO COUNTY,MAMMOTH LAKES PD,13,0,0,13
MONO COUNTY,MONO CO DA,2,0,0,2
MONO COUNTY,MONO CO SD,20,0,16,36
MONTEREY COUNTY,CARMEL PD,14,0,6,20
MONTEREY COUNTY,CSU MONTEREY BAY PD,14,0,0,14
MONTEREY COUNTY,DEL REY OAKS PD,9,6,0,15
MONTEREY COUNTY,GONZALES PD,10,1,0,11
MONTEREY COUNTY,GREENFIELD PD,22,2,0,24
MONTEREY COUNTY,KING CITY PD,16,0,0,16
MONTEREY COUNTY,MARINA PD,26,3,0,29
MONTEREY COUNTY,MONTEREY CO DA,26,0,0,26
MONTEREY COUNTY,MONTEREY CO EMER COMM,0,0,64,64
MONTEREY COUNTY,MONTEREY CO SHERIFF'S OFFICE,296,3,0,299
MONTEREY COUNTY,MONTEREY PD,47,0,0,47
MONTEREY COUNTY,PACIFIC GROVE PD,21,0,0,21
MONTEREY COUNTY,SALINAS PD,153,0,0,153
MONTEREY COUNTY,SAND CITY PD,10,4,0,14
MONTEREY COUNTY,SEASIDE PD,33,1,0,34
MONTEREY COUNTY,SOLEDAD PD,18,6,0,24
NAPA COUNTY,CALISTOGA PD,8,0,7,15
NAPA COUNTY,NAPA CO DA,11,0,0,11
NAPA COUNTY,NAPA CO SD,99,0,0,99
NAPA COUNTY,NAPA PD,73,0,29,102
NAPA COUNTY,NAPA VALLEY COLLEGE DPS,4,0,0,4
NAPA COUNTY,NAPA VALLEY RR PD,2,0,0,2
NAPA COUNTY,SAINT HELENA PD,12,1,7,20
NEVADA COUNTY,GRASS VALLEY PD,28,10,0,38
NEVADA COUNTY,NEVADA CITY PD,10,6,0,16
NEVADA COUNTY,NEVADA CO DA,5,0,0,5
NEVADA COUNTY,NEVADA CO SD,62,3,10,75
NEVADA COUNTY,TRUCKEE PD,23,1,0,24
ORANGE COUNTY,ANAHEIM PD,385,24,33,442
ORANGE COUNTY,BREA PD,56,0,14,70
ORANGE COUNTY,BUENA PARK PD,87,5,16,108
ORANGE COUNTY,COAST CCD PD,1,0,0,1
ORANGE COUNTY,COSTA MESA PD,127,4,23,154
ORANGE COUNTY,CSU FULLERTON PD,27,0,6,33
ORANGE COUNTY,CYPRESS PD,49,0,0,49
ORANGE COUNTY,FOUNTAIN VALLEY PD,59,0,11,70
ORANGE COUNTY,FULLERTON PD,124,4,19,147
ORANGE COUNTY,GARDEN GROVE PD,161,10,18,189
ORANGE COUNTY,HUNTINGTON BEACH PD,209,6,26,241
ORANGE COUNTY,IRVINE PD,219,1,20,240
ORANGE COUNTY,IRVINE VALLEY CCD PD,9,0,4,13
ORANGE COUNTY,LA HABRA PD,67,6,15,88
ORANGE COUNTY,LA PALMA PD,20,3,8,31
ORANGE COUNTY,LAGUNA BEACH PD,56,3,11,70
ORANGE COUNTY,LOS ALAMITOS PD,15,2,0,17
ORANGE COUNTY,NEWPORT BEACH PD,142,4,19,165
ORANGE COUNTY,ORANGE CO DA,175,0,0,175
ORANGE COUNTY,ORANGE CO SD/CORONER,1942,139,59,2140
ORANGE COUNTY,ORANGE PD,148,5,19,172
ORANGE COUNTY,PLACENTIA PD,43,2,9,54
ORANGE COUNTY,SADDLEBACK CCD PD,6,0,2,8
ORANGE COUNTY,SANTA ANA PD,313,5,33,351
ORANGE COUNTY,SANTA ANA UNIF SCHL DIST PD,27,0,0,27
ORANGE COUNTY,SEAL BEACH PD,37,3,0,40
ORANGE COUNTY,TUSTIN PD,86,6,15,107
ORANGE COUNTY,UC IRVINE PD,41,0,10,51
ORANGE COUNTY,WEST CITIES COMM CTR,0,0,23,23
ORANGE COUNTY,WESTMINSTER PD,77,5,13,95
PLACER COUNTY,AUBURN PD,18,3,7,28
PLACER COUNTY,LINCOLN PD,23,0,5,28
PLACER COUNTY,PLACER CO DA,18,0,0,18
PLACER COUNTY,PLACER COUNTY SD,251,88,27,366
PLACER COUNTY,ROCKLIN PD,59,3,12,74
PLACER COUNTY,ROSEVILLE PD,125,2,22,149
PLACER COUNTY,UNION PACIFIC RAILROAD,35,0,0,35
PLUMAS COUNTY,PLUMAS CO SD,33,4,9,46
RIVERSIDE COUNTY,BANNING PD,24,2,6,32
RIVERSIDE COUNTY,BEAUMONT PD,41,0,10,51
RIVERSIDE COUNTY,BLYTHE PD,18,0,7,25
RIVERSIDE COUNTY,CATHEDRAL CITY PD,50,5,20,75
RIVERSIDE COUNTY,CORONA PD,144,0,25,169
RIVERSIDE COUNTY,DESERT HOT SPRINGS PD,32,1,0,33
RIVERSIDE COUNTY,HEMET PD,71,0,15,86
RIVERSIDE COUNTY,INDIO PD,68,0,13,81
RIVERSIDE COUNTY,MURRIETA PD,92,5,20,117
RIVERSIDE COUNTY,PALM SPRINGS PD,95,4,11,110
RIVERSIDE COUNTY,RIVERSIDE CCD PD,22,4,0,26
RIVERSIDE COUNTY,RIVERSIDE CO DA,102,0,2,104
RIVERSIDE COUNTY,RIVERSIDE CO PUBLIC SOCIAL SER,20,0,0,20
RIVERSIDE COUNTY,RIVERSIDE CO SD,1794,32,149,1975
RIVERSIDE COUNTY,RIVERSIDE PD,358,0,50,408
RIVERSIDE COUNTY,UC RIVERSIDE PD,32,0,9,41
RIVERSIDE COUNTY,VAL VERDE UNIF SCH DIST PD,4,2,0,6
SACRAMENTO COUNTY,CA ALCOHOLIC BEVERAGE CONTROL,183,0,0,183
SACRAMENTO COUNTY,CA ASSEMBLY SGT AT ARMS LEGIS,21,0,0,21
SACRAMENTO COUNTY,CA DEPT CONSUMER AFF DEN BD,16,0,0,16
SACRAMENTO COUNTY,CA DEPT CONSUMER AFF INVEST,150,0,0,150
SACRAMENTO COUNTY,CA DEPT DEVELOPMENTAL OPS,88,0,0,88
SACRAMENTO COUNTY,CA DEPT EMPLOYMENT DEVELOPMENT,33,0,0,33
SACRAMENTO COUNTY,CA DEPT FISH & WILDLIFE,377,0,0,377
SACRAMENTO COUNTY,CA DEPT HEALTH CARE SVCS,76,0,0,76
SACRAMENTO COUNTY,CA DEPT INSURANCE FRAUD,178,0,0,178
SACRAMENTO COUNTY,CA DEPT JUSTICE,262,0,0,262
SACRAMENTO COUNTY,CA DEPT MOTOR VEHICLES,198,0,0,198
SACRAMENTO COUNTY,CA DEPT OF MANAGED HEALTH CARE,1,0,0,1
SACRAMENTO COUNTY,CA DEPT PARKS & RECREATION,518,0,43,561
SACRAMENTO COUNTY,CA DEPT PUB HEALTH FOOD/DRUG,86,0,0,86
SACRAMENTO COUNTY,CA DEPT SOCIAL SERVICES,56,0,0,56
SACRAMENTO COUNTY,CA DEPT STATE HOSPITALS,37,0,0,37
SACRAMENTO COUNTY,CA DEPT TOXIC SUBSTANCES CNTL,10,0,0,10
SACRAMENTO COUNTY,CA FRANCHISE TAX BOARD,32,0,0,32
SACRAMENTO COUNTY,CA HIGHWAY PATROL,7347,0,877,8224
SACRAMENTO COUNTY,CA HORSE RACING BOARD,13,0,0,13
SACRAMENTO COUNTY,CA OFFICE OF LE SUPPORT (OLES),3,0,0,3
SACRAMENTO COUNTY,CA SECRETARY OF STATE OFC INV,4,0,0,4
SACRAMENTO COUNTY,CA STATE FAIR PD,5,1,0,6
SACRAMENTO COUNTY,CA STATE LOTTERY,30,0,0,30
SACRAMENTO COUNTY,CAL - OES,17,0,0,17
SACRAMENTO COUNTY,CAL FIRE,163,0,0,163
SACRAMENTO COUNTY,CITRUS HEIGHTS PD,87,9,20,116
SACRAMENTO COUNTY,CSU SACRAMENTO UNIVERSITY PD,23,0,8,31
SACRAMENTO COUNTY,ELK GROVE PD,136,0,21,157
SACRAMENTO COUNTY,FOLSOM PD,76,4,16,96
SACRAMENTO COUNTY,GALT PD,32,2,9,43
SACRAMENTO COUNTY,LOS RIOS CCD PD,21,0,5,26
SACRAMENTO COUNTY,SACRAMENTO CO CORONER,17,0,0,17
SACRAMENTO COUNTY,SACRAMENTO CO DA,43,0,0,43
SACRAMENTO COUNTY,SACRAMENTO CO HUMAN ASST INV,21,0,0,21
SACRAMENTO COUNTY,SACRAMENTO CO REG PARKS DEPT,35,3,0,38
SACRAMENTO COUNTY,SACRAMENTO CO SD,1341,422,68,1831
SACRAMENTO COUNTY,SACRAMENTO PD,655,95,90,840
SACRAMENTO COUNTY,TWIN RIVERS USD PD,19,4,5,28
SAN BENITO COUNTY,HOLLISTER PD,33,1,0,34
SAN BENITO COUNTY,SAN BENITO CO DA,2,0,0,2
SAN BENITO COUNTY,SAN BENITO CO SD,49,13,0,62
SAN BERNARDINO COUNTY,APPLE VALLEY UNIF SCH DIST PD,5,3,1,9
SAN BERNARDINO COUNTY,BARSTOW PD,36,2,9,47
SAN BERNARDINO COUNTY,BURLINGTON NORTHRN SANTA FE RR,36,0,0,36
SAN BERNARDINO COUNTY,CHAFFEY CCD PD,11,0,0,11
SAN BERNARDINO COUNTY,CHINO PD,106,1,21,128
SAN BERNARDINO COUNTY,COLTON PD,49,0,12,61
SAN BERNARDINO COUNTY,CSU SAN BERNARDINO PD,17,0,11,28
SAN BERNARDINO COUNTY,FONTANA PD,186,1,26,213
SAN BERNARDINO COUNTY,FONTANA UNIFIED SCHOOL DIST,17,0,11,28
SAN BERNARDINO COUNTY,HESPERIA UNIFIED SCHOOL DIST,8,0,0,8
SAN BERNARDINO COUNTY,MONTCLAIR PD,42,5,11,58
SAN BERNARDINO COUNTY,ONTARIO PD,281,8,46,335
SAN BERNARDINO COUNTY,REDLANDS PD,84,3,16,103
SAN BERNARDINO COUNTY,RIALTO PD,104,1,13,118
SAN BERNARDINO COUNTY,SAN BERNARDINO CCD PD,11,0,1,12
SAN BERNARDINO COUNTY,SAN BERNARDINO CO DA,57,0,0,57
SAN BERNARDINO COUNTY,SAN BERNARDINO CO SD,1968,163,187,2318
SAN BERNARDINO COUNTY,SAN BERNARDINO PD,240,15,35,290
SAN BERNARDINO COUNTY,SAN BERNARDINO UNIF SCHL DIST,24,7,8,39
SAN BERNARDINO COUNTY,SNOWLINE JOINT UNIF SCHL DIST,3,2,0,5
SAN BERNARDINO COUNTY,UPLAND PD,65,4,16,85
SAN BERNARDINO COUNTY,VICTOR VALLEY COLLEGE PD,7,4,0,11
SAN DIEGO COUNTY,CARLSBAD PD,118,3,22,143
SAN DIEGO COUNTY,CHULA VISTA PD,230,2,28,260
SAN DIEGO COUNTY,CORONADO PD,43,1,8,52
SAN DIEGO COUNTY,CSU SAN DIEGO PD,29,0,10,39
SAN DIEGO COUNTY,CSU SAN MARCOS DPS,17,0,7,24
SAN DIEGO COUNTY,EL CAJON PD,117,21,17,155
SAN DIEGO COUNTY,ESCONDIDO PD,153,10,26,189
SAN DIEGO COUNTY,LA MESA PD,66,2,20,88
SAN DIEGO COUNTY,MIRA COSTA CCD PD,9,0,4,13
SAN DIEGO COUNTY,NATIONAL CITY PD,84,5,12,101
SAN DIEGO COUNTY,OCEANSIDE PD,205,1,27,233
SAN DIEGO COUNTY,PALOMAR CCD PD,12,3,0,15
SAN DIEGO COUNTY,SAN DIEGO CCD PD,35,0,12,47
SAN DIEGO COUNTY,SAN DIEGO CITY SCHOOLS PD,37,0,10,47
SAN DIEGO COUNTY,SAN DIEGO CO DA,122,0,0,122
SAN DIEGO COUNTY,SAN DIEGO CO PUBLIC ASST INV,40,0,0,40
SAN DIEGO COUNTY,SAN DIEGO CO SD,2657,64,142,2863
SAN DIEGO COUNTY,"SAN DIEGO HARBOR PD, PORT OF",135,0,15,150
SAN DIEGO COUNTY,SAN DIEGO PD,1791,20,181,1992
SAN DIEGO COUNTY,SOUTHWESTERN CCD PD,11,0,0,11
SAN DIEGO COUNTY,UC SAN DIEGO PD,37,0,10,47
SAN FRANCISCO COUNTY,CSU SAN FRANCISCO PD,24,0,5,29
SAN FRANCISCO COUNTY,SAN FRAN INT'L AIRPORT COMM,0,0,32,32
SAN FRANCISCO COUNTY,SAN FRANCISCO CCD PD,22,0,1,23
SAN FRANCISCO COUNTY,SAN FRANCISCO CO DA,39,0,0,39
SAN FRANCISCO COUNTY,SAN FRANCISCO CO MED EXAM,13,0,0,13
SAN FRANCISCO COUNTY,SAN FRANCISCO CO SD,843,0,0,843
SAN FRANCISCO COUNTY,SAN FRANCISCO DEPT EMER MGT,1,0,223,224
SAN FRANCISCO COUNTY,SAN FRANCISCO PD,2229,32,0,2261
SAN FRANCISCO COUNTY,UC SAN FRANCISCO PD,48,0,8,56
SAN JOAQUIN COUNTY,ESCALON PD,10,12,0,22
SAN JOAQUIN COUNTY,LODI PD,65,5,16,86
SAN JOAQUIN COUNTY,MANTECA PD,71,4,11,86
SAN JOAQUIN COUNTY,RIPON PD,23,1,6,30
SAN JOAQUIN COUNTY,SAN JOAQUIN CO DA,38,0,0,38
SAN JOAQUIN COUNTY,SAN JOAQUIN CO SD,315,4,29,348
SAN JOAQUIN COUNTY,SAN JOAQUIN DELTA COLLEGE PD,12,1,5,18
SAN JOAQUIN COUNTY,STOCKTON PD,439,30,48,517
SAN JOAQUIN COUNTY,STOCKTON UNIF SCHL DIST PD,33,1,7,41
SAN JOAQUIN COUNTY,TRACY PD,91,1,14,106
SAN LUIS OBISPO COUNTY,ARROYO GRANDE PD,23,2,0,25
SAN LUIS OBISPO COUNTY,ATASCADERO PD,28,0,5,33
SAN LUIS OBISPO COUNTY,CPSU SAN LUIS OBISPO PD,20,0,9,29
SAN LUIS OBISPO COUNTY,CUESTA CCD DPS,7,0,0,7
SAN LUIS OBISPO COUNTY,GROVER BEACH PD,17,2,6,25
SAN LUIS OBISPO COUNTY,MORRO BAY PD,17,0,0,17
SAN LUIS OBISPO COUNTY,PASO ROBLES PD,35,4,9,48
SAN LUIS OBISPO COUNTY,PISMO BEACH PD,20,1,7,28
SAN LUIS OBISPO COUNTY,SAN LUIS OBISPO CO DA,17,0,0,17
SAN LUIS OBISPO COUNTY,SAN LUIS OBISPO CO SD,307,11,25,343
SAN LUIS OBISPO COUNTY,SAN LUIS OBISPO PD,59,2,13,74
SAN MATEO COUNTY,ATHERTON PD,19,5,9,33
SAN MATEO COUNTY,BELMONT PD,30,0,9,39
SAN MATEO COUNTY,BRISBANE PD,15,0,0,15
SAN MATEO COUNTY,BROADMOOR PD,9,19,0,28
SAN MATEO COUNTY,BURLINGAME PD,35,0,14,49
SAN MATEO COUNTY,COLMA PD,19,0,4,23
SAN MATEO COUNTY,DALY CITY PD,94,0,1,95
SAN MATEO COUNTY,EAST PALO ALTO PD,33,0,0,33
SAN MATEO COUNTY,FOSTER CITY PD,36,3,9,48
SAN MATEO COUNTY,HILLSBOROUGH PD,27,1,6,34
SAN MATEO COUNTY,MENLO PARK PD,46,4,15,65
SAN MATEO COUNTY,PACIFICA PD,33,5,0,38
SAN MATEO COUNTY,REDWOOD CITY PD,82,4,18,104
SAN MATEO COUNTY,SAN BRUNO PD,46,4,9,59
SAN MATEO COUNTY,SAN MATEO CO CORONER,9,0,0,9
SAN MATEO COUNTY,SAN MATEO CO DA,17,0,0,17
SAN MATEO COUNTY,SAN MATEO CO PUB SFTY COMM CTR,0,0,72,72
SAN MATEO COUNTY,SAN MATEO CO SD,330,38,0,368
SAN MATEO COUNTY,SAN MATEO PD,106,5,15,126
SAN MATEO COUNTY,SOUTH SAN FRANCISCO PD,77,5,15,97
SANTA BARBARA COUNTY,ALLAN HANCOCK CCD PD,4,1,2,7
SANTA BARBARA COUNTY,GUADALUPE PD,11,1,0,12
SANTA BARBARA COUNTY,LOMPOC PD,40,0,9,49
SANTA BARBARA COUNTY,SANTA BARBARA CO DA,15,0,0,15
SANTA BARBARA COUNTY,SANTA BARBARA CO SD,466,45,37,548
SANTA BARBARA COUNTY,SANTA BARBARA PD,132,11,17,160
SANTA BARBARA COUNTY,SANTA MARIA PD,127,1,19,147
SANTA BARBARA COUNTY,UC SANTA BARBARA PD,43,0,9,52
SANTA CLARA COUNTY,CAMPBELL PD,45,10,15,70
SANTA CLARA COUNTY,CSU SAN JOSE PD,28,2,7,37
SANTA CLARA COUNTY,FOOTHILL-DEANZA CCD PD,11,0,0,11
SANTA CLARA COUNTY,GILROY PD,66,5,12,83
SANTA CLARA COUNTY,LOS ALTOS PD,31,2,11,44
SANTA CLARA COUNTY,LOS GATOS PD,38,5,8,51
SANTA CLARA COUNTY,MILPITAS PD,81,0,12,93
SANTA CLARA COUNTY,MORGAN HILL PD,36,4,10,50
SANTA CLARA COUNTY,MOUNTAIN VIEW PD,89,11,18,118
SANTA CLARA COUNTY,PALO ALTO PD,76,5,19,100
SANTA CLARA COUNTY,SAN JOSE PD,1040,103,148,1291
SANTA CLARA COUNTY,SAN JOSE UNIF SCHL DIST PD,1,0,0,1
SANTA CLARA COUNTY,SAN JOSE/EVERGREEN CCD PD,7,3,0,10
SANTA CLARA COUNTY,SANTA CLARA CO COMM DEPT,0,0,78,78
SANTA CLARA COUNTY,SANTA CLARA CO DA,81,0,0,81
SANTA CLARA COUNTY,SANTA CLARA CO DA-WELFARE FRD,1,0,0,1
SANTA CLARA COUNTY,SANTA CLARA CO SD,1256,62,0,1318
SANTA CLARA COUNTY,SANTA CLARA PD,146,189,24,359
SANTA CLARA COUNTY,SUNNYVALE DPS,200,0,24,224
SANTA CLARA COUNTY,WEST VALLEY CCD PD,10,1,0,11
SANTA CRUZ COUNTY,CAPITOLA PD,19,2,0,21
SANTA CRUZ COUNTY,SANTA CRUZ CO DA,17,0,0,17
SANTA CRUZ COUNTY,SANTA CRUZ CO SD,153,11,0,164
SANTA CRUZ COUNTY,SANTA CRUZ PD,86,1,0,87
SANTA CRUZ COUNTY,SCOTTS VALLEY PD,20,6,6,32
SANTA CRUZ COUNTY,UC SANTA CRUZ PD,21,0,8,29
SANTA CRUZ COUNTY,WATSONVILLE PD,72,1,0,73
SHASTA COUNTY,ANDERSON PD,21,1,0,22
SHASTA COUNTY,REDDING PD,107,1,0,108
SHASTA COUNTY,SHASTA AREA SAFETY COMM AGCY,0,0,39,39
SHASTA COUNTY,SHASTA CO DA,11,0,0,11
SHASTA COUNTY,SHASTA CO MARSHAL,19,0,2,21
SHASTA COUNTY,SHASTA CO SD,121,6,0,127
SIERRA COUNTY,SIERRA CO SHERIFF'S OFFICE,9,1,0,10
SISKIYOU COUNTY,ETNA PD,3,3,0,6
SISKIYOU COUNTY,LAKE SHASTINA DISTRICT PD,2,0,0,2
SISKIYOU COUNTY,MOUNT SHASTA PD,8,2,2,12
SISKIYOU COUNTY,SISKIYOU CO DA,2,0,0,2
SISKIYOU COUNTY,SISKIYOU CO SD,77,9,10,96
SISKIYOU COUNTY,TULELAKE PD,2,0,0,2
SISKIYOU COUNTY,WEED PD,9,2,7,18
SISKIYOU COUNTY,YREKA PD,15,0,7,22
SOLANO COUNTY,BENICIA PD,31,4,15,50
SOLANO COUNTY,CSU CAL MARITIME ACADEMY PD,10,0,0,10
SOLANO COUNTY,DIXON PD,26,0,0,26
SOLANO COUNTY,FAIRFIELD PD,119,0,21,140
SOLANO COUNTY,RIO VISTA PD,13,1,0,14
SOLANO COUNTY,SOLANO CO DA,12,0,0,12
SOLANO COUNTY,SOLANO CO SD,151,11,17,179
SOLANO COUNTY,SOLANO CO SPECIAL INV BUREAU,6,0,0,6
SOLANO COUNTY,SUISUN CITY PD,22,3,9,34
SOLANO COUNTY,VACAVILLE PD,104,2,19,125
SOLANO COUNTY,VALLEJO PD,103,3,24,130
SONOMA COUNTY,CLOVERDALE PD,12,1,7,20
SONOMA COUNTY,COTATI PD,10,3,6,19
SONOMA COUNTY,CSU SONOMA PD,13,0,4,17
SONOMA COUNTY,HEALDSBURG PD,17,0,6,23
SONOMA COUNTY,PETALUMA PD,61,0,13,74
SONOMA COUNTY,ROHNERT PARK DPS,71,0,13,84
SONOMA COUNTY,SANTA ROSA PD,168,0,27,195
SONOMA COUNTY,SEBASTOPOL PD,14,3,6,23
SONOMA COUNTY,SONOMA CO DA,13,0,0,13
SONOMA COUNTY,"SONOMA CO HUM SRV,WLF FRD INV",6,0,0,6
SONOMA COUNTY,SONOMA CO JR COLLEGE DIST PD,9,0,6,15
SONOMA COUNTY,SONOMA CO SHERIFF'S OFFICE,419,1,28,448
SONOMA COUNTY,SONOMA-MARIN AREA RAIL TRANSIT,1,0,0,1
STANISLAUS COUNTY,CERES DPS,48,5,10,63
STANISLAUS COUNTY,CSU STANISLAUS DPS,11,0,2,13
STANISLAUS COUNTY,MODESTO PD,206,9,0,215
STANISLAUS COUNTY,NEWMAN PD,10,5,0,15
STANISLAUS COUNTY,OAKDALE PD,21,7,11,39
STANISLAUS COUNTY,STANISLAUS CO DA,17,0,0,17
STANISLAUS COUNTY,STANISLAUS CO SD,520,25,1,546
STANISLAUS COUNTY,STANISLAUS REGIONAL 9-1-1,1,0,48,49
STANISLAUS COUNTY,TURLOCK PD,75,1,14,90
SUTTER COUNTY,SUTTER CO DA,6,0,0,6
SUTTER COUNTY,SUTTER CO SD,104,17,9,130
SUTTER COUNTY,YUBA CITY PD,58,3,11,72
SUTTER COUNTY,CORNING PD,13,0,8,21
SUTTER COUNTY,RED BLUFF PD,25,2,7,34
SUTTER COUNTY,TEHAMA CO DA,7,0,0,7
SUTTER COUNTY,TEHAMA CO SD,77,6,8,91
TRINITY COUNTY,TRINITY CO MARSHAL,3,0,0,3
TRINITY COUNTY,TRINITY COUNTY SD,30,9,3,42
TULARE COUNTY,COLLEGE OF THE SEQUOIAS PD,6,1,0,7
TULARE COUNTY,DINUBA PD,33,2,6,41
TULARE COUNTY,EXETER PD,17,4,1,22
TULARE COUNTY,FARMERSVILLE PD,14,0,0,14
TULARE COUNTY,LINDSAY DPS,16,2,0,18
TULARE COUNTY,PORTERVILLE PD,62,3,14,79
TULARE COUNTY,TULARE CO DA,37,0,0,37
TULARE COUNTY,TULARE CO SD,569,30,24,623
TULARE COUNTY,TULARE PD,69,0,13,82
TULARE COUNTY,VISALIA PD,145,0,24,169
TULARE COUNTY,WOODLAKE PD,11,2,0,13
TUOLUMNE COUNTY,SONORA PD,10,1,6,17
TUOLUMNE COUNTY,TUOLUMNE CO DA,2,0,0,2
TUOLUMNE COUNTY,TUOLUMNE CO SD,99,5,14,118
VENTURA COUNTY,CSU CHANNEL ISLANDS PD,14,0,6,20
VENTURA COUNTY,OXNARD PD,232,8,21,261
VENTURA COUNTY,PORT HUENEME PD,19,4,4,27
VENTURA COUNTY,SANTA PAULA PD,26,14,6,46
VENTURA COUNTY,SIMI VALLEY PD,114,0,16,130
VENTURA COUNTY,VENTURA CO CCD PD,14,0,0,14
VENTURA COUNTY,VENTURA CO DA,48,0,0,48
VENTURA COUNTY,VENTURA CO SD,747,12,37,796
VENTURA COUNTY,VENTURA PD,131,0,15,146
YOLO COUNTY,DAVIS PD,53,2,15,70
YOLO COUNTY,UC DAVIS PD,43,0,9,52
YOLO COUNTY,WEST SACRAMENTO PD,69,2,0,71
YOLO COUNTY,WINTERS PD,11,3,0,14
YOLO COUNTY,WOODLAND PD,66,0,0,66
YOLO COUNTY,YOLO CO COMM EMER,0,0,37,37
YOLO COUNTY,YOLO CO DA,13,0,0,13
YOLO COUNTY,YOLO CO SHERIFF'S OFFICE,86,6,0,92
YUBA COUNTY,MARYSVILLE PD,17,12,13,42
YUBA COUNTY,WHEATLAND PD,8,3,0,11
YUBA COUNTY,YUBA CO DA,2,0,0,2
YUBA COUNTY,YUBA CO SD,121,24,12,157
YUBA COUNTY,YUBA COMMUNITY COLL DIST PD,4,0,0,4
YUBA COUNTY,** GRAND TOTAL,83996,4306,8098,96400
