County,Agency,Full-Time Sworn,Reserve,Dispatcher,Total
ALAMEDA COUNTY,ALAMEDA CO SD/CORONER,1098,49,45,1192
ALAMEDA COUNTY,ALAMEDA PD,92,0,14,106
ALAMEDA COUNTY,ALAMEDA/CONTRA COSTA TRANSIT,1,0,0,1
ALAMEDA COUNTY,ALBANY PD,26,4,8,38
ALAMEDA COUNTY,BAY AREA RAPID TRANSIT PD,195,0,18,213
ALAMEDA COUNTY,BERKELEY PD,180,23,32,235
ALAMEDA COUNTY,CSU EAST BAY PD,13,0,5,18
ALAMEDA COUNTY,EAST BAY REG PARK DPS,57,2,15,74
ALAMEDA COUNTY,EMERYVILLE PD,38,0,15,53
ALAMEDA COUNTY,FREMONT PD,177,9,25,211
ALAMEDA COUNTY,HAYWARD PD,181,24,29,234
ALAMEDA COUNTY,LIVERMORE PD,91,6,20,117
ALAMEDA COUNTY,MORAGA PD,11,4,0,15
ALAMEDA COUNTY,NEWARK PD,54,3,11,68
ALAMEDA COUNTY,OAKLAND CITY HOUSING AUTH PD,19,2,0,21
ALAMEDA COUNTY,OAKLAND PD,809,12,68,889
ALAMEDA COUNTY,OHLONE CCD PD,3,0,0,3
ALAMEDA COUNTY,PIEDMONT PD,19,3,7,29
ALAMEDA COUNTY,PLEASANTON PD,85,2,18,105
ALAMEDA COUNTY,SAN LEANDRO PD,95,0,15,110
ALAMEDA COUNTY,UC BERKELEY PD,70,0,9,79
ALAMEDA COUNTY,UNION CITY PD,75,1,16,92
ALPINE COUNTY,ALPINE CO SD,16,1,1,18
AMADOR COUNTY,AMADOR CO DA,10,0,0,10
AMADOR COUNTY,AMADOR CO SD/CORONER,48,2,10,60
AMADOR COUNTY,IONE PD,5,4,0,9
AMADOR COUNTY,JACKSON PD,11,8,1,20
AMADOR COUNTY,SUTTER CREEK PD,7,4,0,11
BUTTE COUNTY,BUTTE CCD PD,3,0,0,3
BUTTE COUNTY,BUTTE CO DA,21,0,0,21
BUTTE COUNTY,BUTTE CO SD/CORONER,100,29,15,144
BUTTE COUNTY,CHICO PD,92,2,22,116
BUTTE COUNTY,CSU CHICO PD,17,0,7,24
BUTTE COUNTY,GRIDLEY PD,16,6,7,29
BUTTE COUNTY,OROVILLE PD,24,1,9,34
BUTTE COUNTY,PARADISE PD,24,0,11,35
CALAVERAS COUNTY,ANGELS CAMP PD,10,2,2,14
CALAVERAS COUNTY,CALAVERAS CO DA,3,0,0,3
CALAVERAS COUNTY,CALAVERAS CO SD,58,5,12,75
COLUSA COUNTY,COLUSA CO DISTRICT ATTORNEY,2,0,0,2
COLUSA COUNTY,COLUSA COUNTY SD,32,4,11,47
COLUSA COUNTY,COLUSA PD,9,0,0,9
COLUSA COUNTY,WILLIAMS PD,9,0,0,9
CONTRA COSTA COUNTY,ANTIOCH PD,117,5,20,142
CONTRA COSTA COUNTY,BRENTWOOD PD,60,0,0,60
CONTRA COSTA COUNTY,CLAYTON PD,11,1,0,12
CONTRA COSTA COUNTY,CONCORD PD,159,14,14,187
CONTRA COSTA COUNTY,CONTRA COSTA CCD PD,25,0,0,25
CONTRA COSTA COUNTY,CONTRA COSTA CO DA,17,0,0,17
CONTRA COSTA COUNTY,CONTRA COSTA CO SD/CORONER,667,63,49,779
CONTRA COSTA COUNTY,EL CERRITO PD,41,4,0,45
CONTRA COSTA COUNTY,HERCULES PD,29,4,0,33
CONTRA COSTA COUNTY,KENSINGTON PD,11,2,0,13
CONTRA COSTA COUNTY,MARTINEZ PD,37,7,12,56
CONTRA COSTA COUNTY,PINOLE PD,32,1,9,42
CONTRA COSTA COUNTY,PITTSBURG PD,74,6,0,80
CONTRA COSTA COUNTY,PLEASANT HILL PD,46,5,8,59
CONTRA COSTA COUNTY,RICHMOND PD,174,1,29,204
CONTRA COSTA COUNTY,SAN PABLO PD,56,1,0,57
CONTRA COSTA COUNTY,SAN RAMON PD,56,0,0,56
CONTRA COSTA COUNTY,WALNUT CREEK PD,78,29,15,122
DEL NORTE COUNTY,CRESCENT CITY PD,14,3,1,18
DEL NORTE COUNTY,DEL NORTE CO DA,3,0,0,3
DEL NORTE COUNTY,DEL NORTE COUNTY SD,32,7,4,43
EL DORADO COUNTY,EL DORADO CO DA,13,0,0,13
EL DORADO COUNTY,EL DORADO CO SD,185,9,31,225
EL DORADO COUNTY,PLACERVILLE PD,18,3,6,27
EL DORADO COUNTY,SOUTH LAKE TAHOE PD,43,6,9,58
FRESNO COUNTY,CLOVIS PD,98,17,22,137
FRESNO COUNTY,CLOVIS UNIF SCHL DIST PD,10,0,0,10
FRESNO COUNTY,COALINGA PD,21,6,6,33
FRESNO COUNTY,CSU FRESNO DPS,19,0,5,24
FRESNO COUNTY,FIREBAUGH PD,12,5,0,17
FRESNO COUNTY,FOWLER PD,11,5,0,16
FRESNO COUNTY,FRESNO CO DA,50,0,0,50
FRESNO COUNTY,FRESNO CO SD,457,36,38,531
FRESNO COUNTY,FRESNO PD,817,43,96,956
FRESNO COUNTY,FRESNO YOSEMITE INT'L AIRPORT,5,0,0,5
FRESNO COUNTY,HURON PD,13,11,3,27
FRESNO COUNTY,KERMAN PD,17,1,0,18
FRESNO COUNTY,KINGSBURG PD,16,9,4,29
FRESNO COUNTY,PARLIER PD,17,1,0,18
FRESNO COUNTY,REEDLEY PD,31,0,6,37
FRESNO COUNTY,SANGER PD,31,7,4,42
FRESNO COUNTY,SELMA PD,37,1,7,45
FRESNO COUNTY,STATE CENTER CCD PD,16,0,0,16
GLENN COUNTY,GLENN CO DA,2,0,0,2
GLENN COUNTY,GLENN CO SD/CORONER,30,4,11,45
GLENN COUNTY,ORLAND PD,10,0,0,10
GLENN COUNTY,WILLOWS PD,11,0,0,11
HUMBOLDT COUNTY,ARCATA PD,25,2,6,33
HUMBOLDT COUNTY,CSU HUMBOLDT DPS,15,0,7,22
HUMBOLDT COUNTY,EUREKA PD,45,5,15,65
HUMBOLDT COUNTY,FERNDALE PD,4,1,0,5
HUMBOLDT COUNTY,FORTUNA PD,15,1,6,22
HUMBOLDT COUNTY,HUMBOLDT CO CORONER,4,0,0,4
HUMBOLDT COUNTY,HUMBOLDT CO DA,10,1,0,11
HUMBOLDT COUNTY,HUMBOLDT CO SD,186,23,14,223
HUMBOLDT COUNTY,HUMBOLDT DEPT WELFARE/INVEST,7,0,0,7
HUMBOLDT COUNTY,RIO DELL PD,6,1,0,7
HUMBOLDT COUNTY,TRINIDAD PD,1,2,0,3
IMPERIAL COUNTY,BRAWLEY PD,34,0,7,41
IMPERIAL COUNTY,CALEXICO PD,42,4,9,55
IMPERIAL COUNTY,CALIPATRIA PD,5,3,0,8
IMPERIAL COUNTY,EL CENTRO PD,53,1,10,64
IMPERIAL COUNTY,HOLTVILLE PD,4,0,0,4
IMPERIAL COUNTY,IMPERIAL CO DA,10,0,0,10
IMPERIAL COUNTY,IMPERIAL CO SD,98,6,13,117
IMPERIAL COUNTY,IMPERIAL PD,18,2,0,20
IMPERIAL COUNTY,WESTMORLAND PD,5,1,0,6
INYO COUNTY,BISHOP PD,13,4,6,23
INYO COUNTY,INYO CO DA,2,0,0,2
INYO COUNTY,INYO COUNTY SD,35,9,6,50
KERN COUNTY,ARVIN PD,17,4,5,26
KERN COUNTY,BAKERSFIELD PD,340,23,38,401
KERN COUNTY,BEAR VALLEY PD,8,0,12,20
KERN COUNTY,CALIFORNIA CITY PD,17,8,5,30
KERN COUNTY,CSU BAKERSFIELD DPS,11,0,4,15
KERN COUNTY,DELANO PD,46,5,3,54
KERN COUNTY,KERN CO DA,23,0,0,23
KERN COUNTY,KERN CO-DEPT OF PARKS & REC,11,0,0,11
KERN COUNTY,KERN COUNTY SD,902,97,41,1040
KERN COUNTY,KERN HIGH SCHOOL DISTRICT PD,21,0,0,21
KERN COUNTY,MARICOPA PD,4,0,0,4
KERN COUNTY,RIDGECREST PD,33,11,5,49
KERN COUNTY,SHAFTER PD,20,6,5,31
KERN COUNTY,STALLION SPRINGS PD,3,0,0,3
KERN COUNTY,TAFT PD,15,3,6,24
KERN COUNTY,TEHACHAPI PD,13,3,0,16
KINGS COUNTY,CORCORAN PD,21,2,6,29
KINGS COUNTY,HANFORD PD,53,6,14,73
KINGS COUNTY,KINGS CO DA,12,0,0,12
KINGS COUNTY,KINGS CO SD,82,5,18,105
KINGS COUNTY,"KINGS CO-HUMAN SVCS,WELFARE FD",6,0,0,6
KINGS COUNTY,LEMOORE PD,32,1,0,33
LAKE COUNTY,CLEARLAKE PD,23,1,5,29
LAKE COUNTY,LAKE CO DA,8,0,0,8
LAKE COUNTY,LAKE CO SD,60,4,11,75
LAKE COUNTY,LAKEPORT PD,12,0,0,12
LASSEN COUNTY,LASSEN CO DA,1,0,0,1
LASSEN COUNTY,LASSEN CO SD,33,19,6,58
LASSEN COUNTY,SUSANVILLE PD,16,2,0,18
LOS ANGELES COUNTY,ALHAMBRA PD,82,11,13,106
LOS ANGELES COUNTY,ARCADIA PD,68,6,11,85
LOS ANGELES COUNTY,AZUSA PD,62,7,13,82
LOS ANGELES COUNTY,BALDWIN PARK PD,73,4,10,87
LOS ANGELES COUNTY,BELL GARDENS PD,51,1,6,58
LOS ANGELES COUNTY,BELL PD,40,7,7,54
LOS ANGELES COUNTY,BEVERLY HILLS PD,132,6,19,157
LOS ANGELES COUNTY,BURBANK AIRPORT AUTH PD,26,0,0,26
LOS ANGELES COUNTY,BURBANK PD,162,10,15,187
LOS ANGELES COUNTY,BURLINGTON NORTHRN SANTA FE RR,27,0,0,27
LOS ANGELES COUNTY,CA DEPT CORPORATIONS,2,0,0,2
LOS ANGELES COUNTY,CA DEPT INDUSTRIAL RELATIONS,7,0,0,7
LOS ANGELES COUNTY,CERRITOS CCD PD,10,0,0,10
LOS ANGELES COUNTY,CLAREMONT PD,43,4,7,54
LOS ANGELES COUNTY,COMPTON UNIF SCH DIST PD,36,0,0,36
LOS ANGELES COUNTY,COVINA PD,54,2,11,67
LOS ANGELES COUNTY,CSU DOMINGUEZ HILLS DPS,16,0,6,22
LOS ANGELES COUNTY,CSU LONG BEACH PD,25,0,8,33
LOS ANGELES COUNTY,CSU LOS ANGELES DPS,19,0,6,25
LOS ANGELES COUNTY,CSU NORTHRIDGE DPS,24,0,6,30
LOS ANGELES COUNTY,CSU POMONA DPS,20,0,4,24
LOS ANGELES COUNTY,CULVER CITY PD,107,29,0,136
LOS ANGELES COUNTY,DOWNEY PD,120,0,16,136
LOS ANGELES COUNTY,EL CAMINO CCD PD,26,1,3,30
LOS ANGELES COUNTY,EL MONTE PD,128,57,19,204
LOS ANGELES COUNTY,EL SEGUNDO PD,67,0,12,79
LOS ANGELES COUNTY,GARDENA PD,89,7,0,96
LOS ANGELES COUNTY,GLENDALE CCD PD,10,0,0,10
LOS ANGELES COUNTY,GLENDALE PD,263,7,30,300
LOS ANGELES COUNTY,GLENDALE PD PARK RANGERS,4,2,0,6
LOS ANGELES COUNTY,GLENDORA PD,55,9,13,77
LOS ANGELES COUNTY,HACIENDA LA PUENTE USD,6,0,0,6
LOS ANGELES COUNTY,HAWTHORNE PD,91,4,0,95
LOS ANGELES COUNTY,HERMOSA BEACH PD,37,1,0,38
LOS ANGELES COUNTY,HUNTINGTON PARK PD,70,8,10,88
LOS ANGELES COUNTY,INGLEWOOD PD,188,0,19,207
LOS ANGELES COUNTY,INGLEWOOD UNIF SCH DIST PD,4,5,0,9
LOS ANGELES COUNTY,IRWINDALE PD,29,4,7,40
LOS ANGELES COUNTY,LA VERNE PD,46,17,11,74
LOS ANGELES COUNTY,LONG BEACH PD,970,46,60,1076
LOS ANGELES COUNTY,LOS ANGELES CITY DPT GEN SVCS,101,0,0,101
LOS ANGELES COUNTY,LOS ANGELES CITY HOUSING AUTH,1,0,0,1
LOS ANGELES COUNTY,LOS ANGELES CITY PARK RANGER,16,0,0,16
LOS ANGELES COUNTY,LOS ANGELES CO CORONER,48,0,0,48
LOS ANGELES COUNTY,LOS ANGELES CO DA,294,0,2,296
LOS ANGELES COUNTY,LOS ANGELES CO OFC PUBLIC SFTY,401,2,33,436
LOS ANGELES COUNTY,LOS ANGELES CO SD,9537,855,482,10874
LOS ANGELES COUNTY,LOS ANGELES PD,9813,436,560,10809
LOS ANGELES COUNTY,LOS ANGELES PORT PD,127,2,9,138
LOS ANGELES COUNTY,LOS ANGELES SCHOOL PD,337,0,0,337
LOS ANGELES COUNTY,LOS ANGELES WORLD AIRPORTS PD,515,0,0,515
LOS ANGELES COUNTY,MANHATTAN BEACH PD,64,4,0,68
LOS ANGELES COUNTY,MAYWOOD PD,38,4,5,47
LOS ANGELES COUNTY,MONROVIA PD,54,6,7,67
LOS ANGELES COUNTY,MONTEBELLO PD,83,15,13,111
LOS ANGELES COUNTY,MONTEBELLO UNIFIED SCHOOL DIST,6,0,0,6
LOS ANGELES COUNTY,MONTEREY PARK PD,75,32,11,118
LOS ANGELES COUNTY,PALOS VERDES ESTATES PD,22,27,10,59
LOS ANGELES COUNTY,PASADENA CITY CCD PD,8,0,4,12
LOS ANGELES COUNTY,PASADENA PD,253,16,32,301
LOS ANGELES COUNTY,POMONA PD,181,5,30,216
LOS ANGELES COUNTY,REDONDO BEACH PD,98,14,17,129
LOS ANGELES COUNTY,SAN FERNANDO PD,36,21,7,64
LOS ANGELES COUNTY,SAN GABRIEL PD,56,5,3,64
LOS ANGELES COUNTY,SAN MARINO PD,27,0,5,32
LOS ANGELES COUNTY,SANTA MONICA CCD PD,16,0,6,22
LOS ANGELES COUNTY,SANTA MONICA PD,203,0,16,219
LOS ANGELES COUNTY,SIERRA MADRE PD,17,6,2,25
LOS ANGELES COUNTY,SIGNAL HILL PD,33,3,8,44
LOS ANGELES COUNTY,SOUTH BAY REG PUB COMM AUTH,0,0,44,44
LOS ANGELES COUNTY,SOUTH GATE PD,86,2,8,96
LOS ANGELES COUNTY,SOUTH PASADENA PD,36,11,8,55
LOS ANGELES COUNTY,TORRANCE PD,223,3,22,248
LOS ANGELES COUNTY,UC LOS ANGELES PD,58,0,14,72
LOS ANGELES COUNTY,UNION PACIFIC RAILROAD,59,0,0,59
LOS ANGELES COUNTY,VERNON PD,52,0,10,62
LOS ANGELES COUNTY,WEST COVINA PD,116,19,0,135
LOS ANGELES COUNTY,WHITTIER PD,127,6,10,143
MADERA COUNTY,CHOWCHILLA PD,19,4,6,29
MADERA COUNTY,MADERA CO DA,8,0,0,8
MADERA COUNTY,MADERA CO SD,74,46,11,131
MADERA COUNTY,MADERA PD,58,0,10,68
MARIN COUNTY,BELVEDERE PD,8,0,0,8
MARIN COUNTY,FAIRFAX PD,11,1,5,17
MARIN COUNTY,MARIN CCD PD,7,0,0,7
MARIN COUNTY,MARIN CO CORONER,4,0,0,4
MARIN COUNTY,MARIN CO DA,7,0,0,7
MARIN COUNTY,MARIN CO SD,212,0,49,261
MARIN COUNTY,MILL VALLEY PD,22,2,0,24
MARIN COUNTY,NOVATO PD,58,0,12,70
MARIN COUNTY,ROSS PD,8,1,0,9
MARIN COUNTY,SAN ANSELMO PD,18,3,3,24
MARIN COUNTY,SAN RAFAEL PD,69,4,15,88
MARIN COUNTY,SAUSALITO PD,19,1,0,20
MARIN COUNTY,TIBURON PD,13,3,0,16
MARIN COUNTY,TWIN CITIES PD,33,0,10,43
MARIPOSA COUNTY,MARIPOSA CO DA,1,0,0,1
MARIPOSA COUNTY,MARIPOSA CO SD,40,8,0,48
MENDOCINO COUNTY,FORT BRAGG PD,16,0,0,16
MENDOCINO COUNTY,MENDOCINO CO DA,6,0,0,6
MENDOCINO COUNTY,MENDOCINO CO SD,130,9,13,152
MENDOCINO COUNTY,UKIAH PD,27,3,7,37
MENDOCINO COUNTY,WILLITS PD,14,0,9,23
MERCED COUNTY,ATWATER PD,32,5,8,45
MERCED COUNTY,DOS PALOS PD,7,5,0,12
MERCED COUNTY,GUSTINE PD,9,4,1,14
MERCED COUNTY,LIVINGSTON PD,20,3,7,30
MERCED COUNTY,LOS BANOS PD,38,2,9,49
MERCED COUNTY,MERCED CCD PD,3,0,0,3
MERCED COUNTY,MERCED CO DA,13,0,0,13
MERCED COUNTY,MERCED CO SD,113,35,15,163
MERCED COUNTY,MERCED PD,102,12,19,133
MERCED COUNTY,UC MERCED PD,10,0,5,15
MODOC COUNTY,ALTURAS PD,6,3,0,9
MODOC COUNTY,MODOC CO SD,15,0,5,20
MONO COUNTY,MAMMOTH LAKES PD,23,0,0,23
MONO COUNTY,MONO CO DA,2,0,0,2
MONO COUNTY,MONO CO SD,27,3,15,45
MONTEREY COUNTY,CARMEL PD,14,4,5,23
MONTEREY COUNTY,CSU MONTEREY BAY PD,14,0,0,14
MONTEREY COUNTY,DEL REY OAKS PD,6,15,0,21
MONTEREY COUNTY,GONZALES PD,17,1,0,18
MONTEREY COUNTY,GREENFIELD PD,15,0,0,15
MONTEREY COUNTY,KING CITY PD,15,4,0,19
MONTEREY COUNTY,MARINA PD,32,1,0,33
MONTEREY COUNTY,MONTEREY CO DA,24,0,0,24
MONTEREY COUNTY,MONTEREY CO EMER COMM,1,0,66,67
MONTEREY COUNTY,MONTEREY CO SHERIFF'S OFFICE,302,6,0,308
MONTEREY COUNTY,MONTEREY PD,54,0,0,54
MONTEREY COUNTY,MONTEREY PENN AIRPORT DIST PD,7,0,0,7
MONTEREY COUNTY,PACIFIC GROVE PD,20,3,0,23
MONTEREY COUNTY,SALINAS PD,172,8,0,180
MONTEREY COUNTY,SAND CITY PD,11,3,0,14
MONTEREY COUNTY,SEASIDE PD,46,4,0,50
MONTEREY COUNTY,SOLEDAD PD,22,0,0,22
NAPA COUNTY,CALISTOGA PD,11,1,4,16
NAPA COUNTY,NAPA CO DA,8,0,0,8
NAPA COUNTY,NAPA CO SD,98,0,0,98
NAPA COUNTY,NAPA PD,72,0,22,94
NAPA COUNTY,NAPA VALLEY COLLEGE DPS,4,0,0,4
NAPA COUNTY,NAPA VALLEY RR PD,1,0,0,1
NAPA COUNTY,SAINT HELENA PD,12,1,5,18
NEVADA COUNTY,GRASS VALLEY PD,26,5,6,37
NEVADA COUNTY,NEVADA CITY PD,10,5,0,15
NEVADA COUNTY,NEVADA CO DA,3,0,0,3
NEVADA COUNTY,NEVADA CO SD,72,16,20,108
NEVADA COUNTY,TRUCKEE PD,24,4,0,28
ORANGE COUNTY,ANAHEIM PD,408,22,38,468
ORANGE COUNTY,BREA PD,101,1,17,119
ORANGE COUNTY,BUENA PARK PD,92,8,9,109
ORANGE COUNTY,COSTA MESA COMM DEPT,0,0,24,24
ORANGE COUNTY,COSTA MESA PD,162,7,0,169
ORANGE COUNTY,CSU FULLERTON PD,21,0,8,29
ORANGE COUNTY,CYPRESS PD,56,1,0,57
ORANGE COUNTY,FOUNTAIN VALLEY PD,61,3,7,71
ORANGE COUNTY,FULLERTON PD,157,20,21,198
ORANGE COUNTY,GARDEN GROVE PD,173,26,19,218
ORANGE COUNTY,HUNTINGTON BEACH PD,226,12,30,268
ORANGE COUNTY,IRVINE PD,195,3,19,217
ORANGE COUNTY,IRVINE VALLEY CCD PD,2,0,0,2
ORANGE COUNTY,LA HABRA PD,69,9,11,89
ORANGE COUNTY,LA PALMA PD,24,4,7,35
ORANGE COUNTY,LAGUNA BEACH PD,45,10,11,66
ORANGE COUNTY,LOS ALAMITOS PD,23,4,0,27
ORANGE COUNTY,NEWPORT BEACH PD,141,14,19,174
ORANGE COUNTY,ORANGE CO DA,141,0,0,141
ORANGE COUNTY,ORANGE CO DA WELFARE/FRAUD INV,40,0,0,40
ORANGE COUNTY,ORANGE CO SD/CORONER,1886,245,57,2188
ORANGE COUNTY,ORANGE PD,160,17,19,196
ORANGE COUNTY,PLACENTIA PD,47,3,15,65
ORANGE COUNTY,SADDLEBACK CCD PD,8,0,0,8
ORANGE COUNTY,SANTA ANA PD,358,9,33,400
ORANGE COUNTY,SANTA ANA UNIF SCHL DIST PD,20,0,0,20
ORANGE COUNTY,SEAL BEACH PD,30,5,0,35
ORANGE COUNTY,TUSTIN PD,92,7,15,114
ORANGE COUNTY,UC IRVINE PD,31,0,9,40
ORANGE COUNTY,WEST CITIES COMM CTR,0,0,22,22
ORANGE COUNTY,WESTMINSTER PD,102,7,13,122
PLACER COUNTY,AUBURN PD,20,7,7,34
PLACER COUNTY,LINCOLN PD,32,4,8,44
PLACER COUNTY,PLACER CO DA,10,0,0,10
PLACER COUNTY,PLACER COUNTY SD,232,68,31,331
PLACER COUNTY,ROCKLIN PD,54,6,15,75
PLACER COUNTY,ROSEVILLE PD,124,5,25,154
PLUMAS COUNTY,PLUMAS CO SD,33,12,9,54
RIVERSIDE COUNTY,BANNING PD,36,1,9,46
RIVERSIDE COUNTY,BEAUMONT PD,59,0,15,74
RIVERSIDE COUNTY,BLYTHE PD,24,5,9,38
RIVERSIDE COUNTY,CATHEDRAL CITY PD,55,15,18,88
RIVERSIDE COUNTY,CORONA PD,180,3,29,212
RIVERSIDE COUNTY,DESERT HOT SPRINGS  PD,30,5,1,36
RIVERSIDE COUNTY,HEMET PD,75,0,16,91
RIVERSIDE COUNTY,INDIO PD,73,11,17,101
RIVERSIDE COUNTY,LAKE HEMET MUNCPL WATER DIST,0,0,0,0
RIVERSIDE COUNTY,MOUNT SAN JACINTO CCD PD,3,0,0,3
RIVERSIDE COUNTY,MURRIETA PD,90,2,22,114
RIVERSIDE COUNTY,PALM SPRINGS PD,96,22,16,134
RIVERSIDE COUNTY,RIVERSIDE CCD PD,18,9,0,27
RIVERSIDE COUNTY,RIVERSIDE CO DA,135,0,2,137
RIVERSIDE COUNTY,RIVERSIDE CO PUBLIC SOCIAL SER,26,0,0,26
RIVERSIDE COUNTY,RIVERSIDE CO SD,2155,45,181,2381
RIVERSIDE COUNTY,RIVERSIDE PD,378,1,52,431
RIVERSIDE COUNTY,UC RIVERSIDE PD,29,0,8,37
SACRAMENTO COUNTY,CA ALCOHOLIC BEVERAGE CONTROL,189,0,0,189
SACRAMENTO COUNTY,CA ASSEMBLY SGT AT ARMS LEGIS,18,0,0,18
SACRAMENTO COUNTY,CA DEPT CONSUMER AFF DEN BD,13,0,0,13
SACRAMENTO COUNTY,CA DEPT CONSUMER AFF INVEST,52,0,0,52
SACRAMENTO COUNTY,CA DEPT CONSUMER AFF MED BD,99,0,0,99
SACRAMENTO COUNTY,CA DEPT DEVELOPMENTAL OPS,107,0,0,107
SACRAMENTO COUNTY,CA DEPT EMPLOYMENT DEVELOPMENT,38,0,0,38
SACRAMENTO COUNTY,CA DEPT FISH & GAME,307,0,0,307
SACRAMENTO COUNTY,CA DEPT HEALTH CARE SVCS,129,0,0,129
SACRAMENTO COUNTY,CA DEPT INSURANCE FRAUD,206,0,0,206
SACRAMENTO COUNTY,CA DEPT JUSTICE,499,0,0,499
SACRAMENTO COUNTY,CA DEPT MENTAL HEALTH,19,0,0,19
SACRAMENTO COUNTY,CA DEPT MOTOR VEHICLES,223,0,0,223
SACRAMENTO COUNTY,CA DEPT PARKS & RECREATION,679,0,66,745
SACRAMENTO COUNTY,CA DEPT PUB HEALTH FOOD/DRUG,112,0,0,112
SACRAMENTO COUNTY,CA DEPT SOCIAL SERVICES,55,0,0,55
SACRAMENTO COUNTY,CA DEPT TOXIC SUBSTANCES CNTL,15,0,0,15
SACRAMENTO COUNTY,CA FRANCHISE TAX BOARD,39,0,0,39
SACRAMENTO COUNTY,CA HIGHWAY PATROL,7467,0,1,7468
SACRAMENTO COUNTY,CA HORSE RACING BOARD,17,0,0,17
SACRAMENTO COUNTY,CA OFFICE OF EMERGENCY SERV,8,0,0,8
SACRAMENTO COUNTY,CA SECRETARY OF STATE OFC INV,7,0,0,7
SACRAMENTO COUNTY,CA STATE CONTROLLER,3,0,0,3
SACRAMENTO COUNTY,CA STATE FAIR PD,5,0,0,5
SACRAMENTO COUNTY,CA STATE LOTTERY,26,0,0,26
SACRAMENTO COUNTY,CAL FIRE-ARSON & BOMB,241,0,0,241
SACRAMENTO COUNTY,CITRUS HEIGHTS PD,86,12,21,119
SACRAMENTO COUNTY,CSU SACRAMENTO DPS,23,0,0,23
SACRAMENTO COUNTY,ELK GROVE PD,123,13,22,158
SACRAMENTO COUNTY,FOLSOM PD,83,9,16,108
SACRAMENTO COUNTY,GALT PD,30,1,8,39
SACRAMENTO COUNTY,ISLETON PD,5,4,0,9
SACRAMENTO COUNTY,LOS RIOS CCD PD,30,1,0,31
SACRAMENTO COUNTY,SACRAMENTO CO CORONER,15,0,0,15
SACRAMENTO COUNTY,SACRAMENTO CO DA,48,0,0,48
SACRAMENTO COUNTY,SACRAMENTO CO HUMAN ASST INV,26,0,0,26
SACRAMENTO COUNTY,SACRAMENTO CO REG PARKS DEPT,23,0,0,23
SACRAMENTO COUNTY,SACRAMENTO CO SD,1382,590,59,2031
SACRAMENTO COUNTY,SACRAMENTO PD,702,65,85,852
SACRAMENTO COUNTY,TWIN RIVERS USD PD,22,10,0,32
SAN BENITO COUNTY,HOLLISTER PD,27,2,0,29
SAN BENITO COUNTY,SAN BENITO CO DA,2,0,0,2
SAN BENITO COUNTY,SAN BENITO CO MARSHAL,1,6,0,7
SAN BENITO COUNTY,SAN BENITO CO OES,0,0,16,16
SAN BENITO COUNTY,SAN BENITO CO SD,33,5,0,38
SAN BERNARDINO COUNTY,BARSTOW PD,40,3,7,50
SAN BERNARDINO COUNTY,CHINO PD,97,3,20,120
SAN BERNARDINO COUNTY,COLTON PD,62,5,12,79
SAN BERNARDINO COUNTY,CSU SAN BERNARDINO DPS,15,0,8,23
SAN BERNARDINO COUNTY,FONTANA PD,190,3,23,216
SAN BERNARDINO COUNTY,FONTANA UNIFIED SCHOOL DIST,15,0,9,24
SAN BERNARDINO COUNTY,HESPERIA UNIFIED SCHOOL DIST,6,0,0,6
SAN BERNARDINO COUNTY,MONTCLAIR PD,58,7,9,74
SAN BERNARDINO COUNTY,ONTARIO PD,225,8,42,275
SAN BERNARDINO COUNTY,REDLANDS PD,83,11,17,111
SAN BERNARDINO COUNTY,RIALTO PD,107,2,14,123
SAN BERNARDINO COUNTY,SAN BERNARDINO CCD PD,9,0,0,9
SAN BERNARDINO COUNTY,SAN BERNARDINO CO DA,56,0,0,56
SAN BERNARDINO COUNTY,SAN BERNARDINO CO SD,1903,264,189,2356
SAN BERNARDINO COUNTY,SAN BERNARDINO PD,322,28,43,393
SAN BERNARDINO COUNTY,SAN BERNARDINO UNIF SCHL DIST,25,3,6,34
SAN BERNARDINO COUNTY,SNOWLINE JOINT UNIF SCHL DIST,4,1,0,5
SAN BERNARDINO COUNTY,UPLAND PD,79,9,17,105
SAN DIEGO COUNTY,CARLSBAD PD,112,6,20,138
SAN DIEGO COUNTY,CHULA VISTA PD,231,11,24,266
SAN DIEGO COUNTY,CORONADO PD,41,2,8,51
SAN DIEGO COUNTY,CSU SAN DIEGO DPS,30,0,11,41
SAN DIEGO COUNTY,CSU SAN MARCOS DPS,16,0,6,22
SAN DIEGO COUNTY,EL CAJON PD,119,21,13,153
SAN DIEGO COUNTY,ESCONDIDO PD,154,12,26,192
SAN DIEGO COUNTY,GROSSMONT-CUYAMACA CCD PD,9,0,0,9
SAN DIEGO COUNTY,LA MESA PD,64,3,18,85
SAN DIEGO COUNTY,MIRA COSTA CCD PD,10,0,3,13
SAN DIEGO COUNTY,NATIONAL CITY PD,89,8,12,109
SAN DIEGO COUNTY,OCEANSIDE PD,207,5,28,240
SAN DIEGO COUNTY,OCEANSIDE SM CRAFT HARBOR DIST,10,1,0,11
SAN DIEGO COUNTY,PALOMAR CCD PD,11,0,0,11
SAN DIEGO COUNTY,SAN DIEGO CCD PD,37,0,8,45
SAN DIEGO COUNTY,SAN DIEGO CITY SCHOOLS PD,43,0,7,50
SAN DIEGO COUNTY,SAN DIEGO CO DA,178,0,0,178
SAN DIEGO COUNTY,SAN DIEGO CO SD,1345,111,129,1585
SAN DIEGO COUNTY,"SAN DIEGO HARBOR PD, PORT OF",137,0,13,150
SAN DIEGO COUNTY,SAN DIEGO PD,1943,27,168,2138
SAN DIEGO COUNTY,SOUTHWESTERN CCD PD,9,0,0,9
SAN DIEGO COUNTY,UC SAN DIEGO PD,34,0,8,42
SAN FRANCISCO COUNTY,CSU SAN FRANCISCO DPS,26,0,5,31
SAN FRANCISCO COUNTY,SAN FRANCISCO CCD PD,29,0,0,29
SAN FRANCISCO COUNTY,SAN FRANCISCO CO DA,29,0,0,29
SAN FRANCISCO COUNTY,SAN FRANCISCO CO MED EXAM,12,0,0,12
SAN FRANCISCO COUNTY,SAN FRANCISCO CO SD,897,0,0,897
SAN FRANCISCO COUNTY,SAN FRANCISCO DEPT EMER MGT,1,0,196,197
SAN FRANCISCO COUNTY,SAN FRANCISCO MUNICIPAL RWY PD,3,0,0,3
SAN FRANCISCO COUNTY,SAN FRANCISCO PD,2323,25,0,2348
SAN FRANCISCO COUNTY,SUPREME COURT OF CALIFORNIA,1,0,0,1
SAN FRANCISCO COUNTY,UC SAN FRANCISCO PD,38,0,9,47
SAN JOAQUIN COUNTY,ESCALON PD,11,13,1,25
SAN JOAQUIN COUNTY,LODI PD,72,6,22,100
SAN JOAQUIN COUNTY,MANTECA PD,76,15,10,101
SAN JOAQUIN COUNTY,RIPON PD,27,3,7,37
SAN JOAQUIN COUNTY,SAN JOAQUIN CO DA,36,0,0,36
SAN JOAQUIN COUNTY,SAN JOAQUIN CO SD,328,3,36,367
SAN JOAQUIN COUNTY,SAN JOAQUIN DELTA COLLEGE PD,10,0,0,10
SAN JOAQUIN COUNTY,STOCKTON PD,396,23,44,463
SAN JOAQUIN COUNTY,STOCKTON UNIF SCHL DIST PD,18,1,5,24
SAN JOAQUIN COUNTY,TRACY PD,89,2,16,107
SAN LUIS OBISPO COUNTY,ARROYO GRANDE PD,28,5,7,40
SAN LUIS OBISPO COUNTY,ATASCADERO PD,31,0,8,39
SAN LUIS OBISPO COUNTY,CPSU SAN LUIS OBISPO PD,19,0,6,25
SAN LUIS OBISPO COUNTY,CUESTA CCD DPS,6,0,0,6
SAN LUIS OBISPO COUNTY,GROVER BEACH PD,17,2,9,28
SAN LUIS OBISPO COUNTY,MORRO BAY PD,17,1,5,23
SAN LUIS OBISPO COUNTY,PASO ROBLES PD,36,5,9,50
SAN LUIS OBISPO COUNTY,PISMO BEACH PD,22,3,6,31
SAN LUIS OBISPO COUNTY,SAN LUIS OBISPO CO DA,15,0,0,15
SAN LUIS OBISPO COUNTY,SAN LUIS OBISPO CO SD,162,10,16,188
SAN LUIS OBISPO COUNTY,SAN LUIS OBISPO PD,60,0,14,74
SAN MATEO COUNTY,ATHERTON PD,19,5,13,37
SAN MATEO COUNTY,BELMONT PD,31,3,11,45
SAN MATEO COUNTY,BRISBANE PD,15,0,0,15
SAN MATEO COUNTY,BROADMOOR PD,7,23,0,30
SAN MATEO COUNTY,BURLINGAME PD,42,5,16,63
SAN MATEO COUNTY,COLMA PD,18,0,5,23
SAN MATEO COUNTY,DALY CITY PD,110,2,21,133
SAN MATEO COUNTY,EAST PALO ALTO PD,29,0,0,29
SAN MATEO COUNTY,FOSTER CITY PD,39,5,13,57
SAN MATEO COUNTY,HALF MOON BAY PD,14,2,0,16
SAN MATEO COUNTY,HILLSBOROUGH PD,27,1,5,33
SAN MATEO COUNTY,MENLO PARK PD,50,4,19,73
SAN MATEO COUNTY,MILLBRAE PD,19,3,4,26
SAN MATEO COUNTY,PACIFICA PD,36,8,9,53
SAN MATEO COUNTY,REDWOOD CITY PD,96,7,12,115
SAN MATEO COUNTY,SAN BRUNO PD,45,7,6,58
SAN MATEO COUNTY,SAN CARLOS PD,31,10,0,41
SAN MATEO COUNTY,SAN MATEO CO CORONER,7,0,0,7
SAN MATEO COUNTY,SAN MATEO CO DA,12,0,0,12
SAN MATEO COUNTY,SAN MATEO CO PUB SFTY COMM CTR,0,0,36,36
SAN MATEO COUNTY,SAN MATEO CO SD,313,40,0,353
SAN MATEO COUNTY,SAN MATEO PD,106,9,21,136
SAN MATEO COUNTY,SOUTH SAN FRANCISCO PD,75,12,14,101
SANTA BARBARA COUNTY,ALLAN HANCOCK CCD PD,3,1,2,6
SANTA BARBARA COUNTY,GUADALUPE PD,10,4,2,16
SANTA BARBARA COUNTY,LOMPOC PD,51,3,10,64
SANTA BARBARA COUNTY,SANTA BARBARA CO DA,21,0,0,21
SANTA BARBARA COUNTY,SANTA BARBARA CO SD,281,32,34,347
SANTA BARBARA COUNTY,SANTA BARBARA PD,132,11,12,155
SANTA BARBARA COUNTY,SANTA MARIA PD,111,6,22,139
SANTA BARBARA COUNTY,UC SANTA BARBARA PD,31,0,7,38
SANTA CLARA COUNTY,CAMPBELL PD,41,12,13,66
SANTA CLARA COUNTY,CSU SAN JOSE PD,30,0,6,36
SANTA CLARA COUNTY,FOOTHILL-DEANZA CCD PD,9,0,0,9
SANTA CLARA COUNTY,GILROY PD,59,6,15,80
SANTA CLARA COUNTY,LOS ALTOS PD,29,6,9,44
SANTA CLARA COUNTY,LOS GATOS PD,42,7,6,55
SANTA CLARA COUNTY,MILPITAS PD,85,4,15,104
SANTA CLARA COUNTY,MORGAN HILL PD,36,4,10,50
SANTA CLARA COUNTY,MOUNTAIN VIEW EMERG COMM,0,1,18,19
SANTA CLARA COUNTY,MOUNTAIN VIEW PD,96,17,0,113
SANTA CLARA COUNTY,PALO ALTO PD,85,9,23,117
SANTA CLARA COUNTY,SAN JOSE PD,1348,133,166,1647
SANTA CLARA COUNTY,SAN JOSE UNIF SCHL DIST PD,1,0,0,1
SANTA CLARA COUNTY,SAN JOSE/EVERGREEN CCD PD,5,0,1,6
SANTA CLARA COUNTY,SANTA CLARA CO COMM DEPT,0,0,96,96
SANTA CLARA COUNTY,SANTA CLARA CO DA,73,0,0,73
SANTA CLARA COUNTY,SANTA CLARA CO DA-WELFARE FRD,5,0,0,5
SANTA CLARA COUNTY,SANTA CLARA CO SD,466,67,0,533
SANTA CLARA COUNTY,SANTA CLARA PD,140,26,23,189
SANTA CLARA COUNTY,SUNNYVALE DPS,217,0,22,239
SANTA CLARA COUNTY,WEST VALLEY CCD PD,9,2,0,11
SANTA CRUZ COUNTY,CAPITOLA PD,22,4,0,26
SANTA CRUZ COUNTY,SANTA CRUZ CO DA,14,0,0,14
SANTA CRUZ COUNTY,SANTA CRUZ CO SD,139,26,0,165
SANTA CRUZ COUNTY,SANTA CRUZ PD,92,1,0,93
SANTA CRUZ COUNTY,SCOTTS VALLEY PD,19,6,6,31
SANTA CRUZ COUNTY,UC SANTA CRUZ PD,18,0,8,26
SANTA CRUZ COUNTY,WATSONVILLE PD,64,0,0,64
SHASTA COUNTY,ANDERSON PD,18,0,6,24
SHASTA COUNTY,REDDING PD,112,0,0,112
SHASTA COUNTY,SHASTA AREA SAFETY COMM AGCY,1,0,47,48
SHASTA COUNTY,SHASTA CO DA,14,0,0,14
SHASTA COUNTY,SHASTA CO MARSHAL,24,0,0,24
SHASTA COUNTY,SHASTA CO SD,153,16,0,169
SIERRA COUNTY,SIERRA CO SD,10,1,0,11
SISKIYOU COUNTY,ETNA PD,2,0,0,2
SISKIYOU COUNTY,LAKE SHASTINA DISTRICT PD,4,0,0,4
SISKIYOU COUNTY,MOUNT SHASTA PD,9,3,3,15
SISKIYOU COUNTY,SISKIYOU CO DA,5,0,0,5
SISKIYOU COUNTY,SISKIYOU CO SD,93,8,10,111
SISKIYOU COUNTY,TULELAKE PD,3,0,0,3
SISKIYOU COUNTY,WEED PD,9,0,4,13
SISKIYOU COUNTY,YREKA PD,15,3,4,22
SOLANO COUNTY,BENICIA PD,36,0,13,49
SOLANO COUNTY,DIXON PD,25,1,0,26
SOLANO COUNTY,FAIRFIELD PD,122,0,19,141
SOLANO COUNTY,RIO VISTA PD,9,2,0,11
SOLANO COUNTY,SOLANO CCD PD,3,0,0,3
SOLANO COUNTY,SOLANO CO DA,13,0,0,13
SOLANO COUNTY,SOLANO CO SD,113,19,16,148
SOLANO COUNTY,SUISUN CITY PD,26,1,4,31
SOLANO COUNTY,VACAVILLE PD,112,3,20,135
SOLANO COUNTY,VALLEJO PD,117,6,23,146
SONOMA COUNTY,CLOVERDALE PD,14,3,8,25
SONOMA COUNTY,COTATI PD,12,2,6,20
SONOMA COUNTY,CSU SONOMA DPS,12,0,6,18
SONOMA COUNTY,HEALDSBURG PD,19,0,6,25
SONOMA COUNTY,PETALUMA PD,67,0,13,80
SONOMA COUNTY,ROHNERT PARK DPS,77,0,16,93
SONOMA COUNTY,SANTA ROSA JUNIOR COLLEGE PD,12,0,7,19
SONOMA COUNTY,SANTA ROSA PD,172,0,23,195
SONOMA COUNTY,SEBASTOPOL PD,14,10,6,30
SONOMA COUNTY,SONOMA CO DA,17,0,0,17
SONOMA COUNTY,"SONOMA CO HUM SRV,WLF FRD INV",5,0,0,5
SONOMA COUNTY,SONOMA CO SD,254,7,34,295
STANISLAUS COUNTY,CERES DPS,51,4,8,63
STANISLAUS COUNTY,CSU STANISLAUS DPS,11,0,5,16
STANISLAUS COUNTY,MODESTO PD,248,14,0,262
STANISLAUS COUNTY,NEWMAN PD,12,4,0,16
STANISLAUS COUNTY,OAKDALE PD,26,5,6,37
STANISLAUS COUNTY,STANISLAUS CO DA,17,0,0,17
STANISLAUS COUNTY,STANISLAUS CO SD,229,49,0,278
STANISLAUS COUNTY,STANISLAUS REGIONAL 9-1-1,0,0,55,55
STANISLAUS COUNTY,TURLOCK PD,82,0,18,100
SUTTER COUNTY,SUTTER CO DA,10,0,0,10
SUTTER COUNTY,SUTTER CO SD,109,24,14,147
SUTTER COUNTY,YUBA CITY PD,64,9,12,85
TEHEMA COUNTY,CORNING PD,15,0,4,19
TEHEMA COUNTY,RED BLUFF PD,25,0,7,32
TEHEMA COUNTY,TEHAMA CO DA,7,0,0,7
TEHEMA COUNTY,TEHAMA CO SD,86,8,7,101
TRINITY COUNTY,TRINITY CO DIST ATTORNEY,1,0,0,1
TRINITY COUNTY,TRINITY CO MARSHAL,3,0,0,3
TRINITY COUNTY,TRINITY COUNTY SD,17,7,0,24
TULARE COUNTY,COLLEGE OF THE SEQUOIAS PD,5,0,1,6
TULARE COUNTY,DINUBA PD,37,0,6,43
TULARE COUNTY,EXETER PD,17,9,0,26
TULARE COUNTY,FARMERSVILLE PD,16,0,0,16
TULARE COUNTY,LINDSAY DPS,15,6,2,23
TULARE COUNTY,PORTERVILLE PD,59,5,11,75
TULARE COUNTY,TULARE CO DA,31,0,0,31
TULARE COUNTY,TULARE CO SD,305,35,20,360
TULARE COUNTY,TULARE PD,71,1,12,84
TULARE COUNTY,VISALIA PD,138,9,20,167
TULARE COUNTY,WOODLAKE PD,13,3,2,18
TUOLUMNE COUNTY,SONORA PD,13,2,5,20
TUOLUMNE COUNTY,TUOLUMNE CO DA,4,0,0,4
TUOLUMNE COUNTY,TUOLUMNE CO SD,61,8,12,81
VENTURA COUNTY,CSU CHANNEL ISLANDS PD,12,0,6,18
VENTURA COUNTY,OXNARD PD,223,13,24,260
VENTURA COUNTY,PORT HUENEME PD,24,7,5,36
VENTURA COUNTY,SANTA PAULA PD,32,27,7,66
VENTURA COUNTY,SIMI VALLEY PD,123,2,16,141
VENTURA COUNTY,VENTURA CO CCD PD,15,0,0,15
VENTURA COUNTY,VENTURA CO DA,44,0,0,44
VENTURA COUNTY,VENTURA CO SD,719,24,34,777
VENTURA COUNTY,VENTURA PD,131,0,13,144
YOLO COUNTY,DAVIS PD,58,4,14,76
YOLO COUNTY,UC DAVIS PD,47,0,11,58
YOLO COUNTY,WEST SACRAMENTO PD,67,2,0,69
YOLO COUNTY,WINTERS PD,10,2,0,12
YOLO COUNTY,WOODLAND PD,66,0,0,66
YOLO COUNTY,YOLO CO COMM EMER,0,0,37,37
YOLO COUNTY,YOLO CO DA,14,0,0,14
YOLO COUNTY,YOLO CO SD,89,3,0,92
YUBA COUNTY,MARYSVILLE PD,18,16,6,40
YUBA COUNTY,WHEATLAND PD,7,1,0,8
YUBA COUNTY,YUBA CO SD,86,27,13,126
YUBA COUNTY,YUBA COMMUNITY COLL DIST PD,6,2,0,8
