County,Agency,Sworn,Reserve,Dispatcher,Total
ALAMEDA COUNTY,ALAMEDA CO SD/CORONER,1031,6,34,1071
ALAMEDA COUNTY,ALAMEDA PD,74,0,18,92
ALAMEDA COUNTY,ALBANY PD,23,2,8,33
ALAMEDA COUNTY,BAY AREA RAPID TRANSIT PD,205,0,19,224
ALAMEDA COUNTY,BERKELEY PD,150,14,31,195
ALAMEDA COUNTY,CSU EAST BAY PD,13,0,0,13
ALAMEDA COUNTY,EAST BAY REG PARK DPS,55,0,17,72
ALAMEDA COUNTY,EMERYVILLE PD,34,0,10,44
ALAMEDA COUNTY,FREMONT PD,171,7,27,205
ALAMEDA COUNTY,HAYWARD PD,161,21,31,213
ALAMEDA COUNTY,LIVERMORE PD,92,4,20,116
ALAMEDA COUNTY,NEWARK PD,49,1,11,61
ALAMEDA COUNTY,OAKLAND CITY HOUSING AUTH PD,27,3,0,30
ALAMEDA COUNTY,OAKLAND PD,636,5,73,714
ALAMEDA COUNTY,OHLONE CCD PD,2,0,1,3
ALAMEDA COUNTY,PIEDMONT PD,18,3,6,27
ALAMEDA COUNTY,PLEASANTON PD,79,1,16,96
ALAMEDA COUNTY,SAN LEANDRO PD,66,0,13,79
ALAMEDA COUNTY,UC BERKELEY PD,48,0,8,56
ALAMEDA COUNTY,UNION CITY PD,68,0,1,69
ALPINE COUNTY,ALPINE CO SO,12,3,0,15
AMADOR COUNTY,AMADOR CO DA,8,0,0,8
AMADOR COUNTY,AMADOR CO SO/CORONER,46,9,8,63
AMADOR COUNTY,IONE PD,6,1,0,7
AMADOR COUNTY,JACKSON PD,8,5,0,13
AMADOR COUNTY,SUTTER CREEK PD,5,2,0,7
BUTTE COUNTY,BUTTE CCD PD,4,0,0,4
BUTTE COUNTY,BUTTE CO DA,17,0,0,17
BUTTE COUNTY,BUTTE CO SO/CORONER,179,21,15,215
BUTTE COUNTY,CHICO PD,94,0,23,117
BUTTE COUNTY,CSU CHICO PD,12,0,5,17
BUTTE COUNTY,GRIDLEY PD,11,6,9,26
BUTTE COUNTY,OROVILLE PD,18,4,7,29
BUTTE COUNTY,PARADISE PD,17,0,3,20
CALAVERAS COUNTY,ANGELS CAMP PD,6,1,0,7
CALAVERAS COUNTY,CALAVERAS CO DA,1,0,0,1
CALAVERAS COUNTY,CALAVERAS CO SD,56,3,9,68
COLUSA COUNTY,COLUSA CO DISTRICT ATTORNEY,3,0,0,3
COLUSA COUNTY,COLUSA COUNTY SD,30,0,7,37
COLUSA COUNTY,COLUSA PD,7,0,0,7
COLUSA COUNTY,WILLIAMS PD,12,0,0,12
CONTRA COSTA COUNTY,ANTIOCH PD,112,1,16,129
CONTRA COSTA COUNTY,BRENTWOOD PD,65,0,14,79
CONTRA COSTA COUNTY,CLAYTON PD,11,0,0,11
CONTRA COSTA COUNTY,CONCORD PD,127,4,16,147
CONTRA COSTA COUNTY,CONTRA COSTA CCD PD,21,0,0,21
CONTRA COSTA COUNTY,CONTRA COSTA CO DA,27,0,0,27
CONTRA COSTA COUNTY,CONTRA COSTA CO SO/CORONER,618,28,37,683
CONTRA COSTA COUNTY,EL CERRITO PD,27,0,0,27
CONTRA COSTA COUNTY,HERCULES PD,25,1,0,26
CONTRA COSTA COUNTY,KENSINGTON PD,6,0,0,6
CONTRA COSTA COUNTY,MARTINEZ PD,28,4,5,37
CONTRA COSTA COUNTY,MORAGA PD,12,1,0,13
CONTRA COSTA COUNTY,OAKLEY PD,34,0,0,34
CONTRA COSTA COUNTY,PINOLE PD,22,0,12,34
CONTRA COSTA COUNTY,PITTSBURG PD,89,2,0,91
CONTRA COSTA COUNTY,PLEASANT HILL PD,40,0,12,52
CONTRA COSTA COUNTY,RICHMOND PD,116,3,21,140
CONTRA COSTA COUNTY,SAN PABLO PD,55,0,0,55
CONTRA COSTA COUNTY,SAN RAMON PD,67,0,0,67
CONTRA COSTA COUNTY,WALNUT CREEK PD,76,26,20,122
DEL NORTE COUNTY,CRESCENT CITY PD,11,0,0,11
DEL NORTE COUNTY,DEL NORTE CO DA,2,0,0,2
DEL NORTE COUNTY,DEL NORTE COUNTY SO,18,7,2,27
EL DORADO COUNTY,EL DORADO CO DA,15,0,0,15
EL DORADO COUNTY,EL DORADO CO SO,165,4,16,185
EL DORADO COUNTY,PLACERVILLE PD,19,1,5,25
EL DORADO COUNTY,SOUTH LAKE TAHOE PD,39,5,7,51
FRESNO COUNTY,CLOVIS PD,106,10,23,139
FRESNO COUNTY,CLOVIS UNIF SCHL DIST PD,15,1,0,16
FRESNO COUNTY,COALINGA PD,18,0,8,26
FRESNO COUNTY,CSU FRESNO DPS,25,0,6,31
FRESNO COUNTY,FIREBAUGH PD,13,6,0,19
FRESNO COUNTY,FOWLER PD,11,0,0,11
FRESNO COUNTY,FRESNO CO DA,53,0,0,53
FRESNO COUNTY,FRESNO CO SO,411,72,57,540
FRESNO COUNTY,FRESNO PD,801,19,99,919
FRESNO COUNTY,FRESNO YOSEMITE INT'L AIRPORT,7,0,0,7
FRESNO COUNTY,HURON PD,11,2,4,17
FRESNO COUNTY,KERMAN PD,26,3,0,29
FRESNO COUNTY,KINGSBURG PD,23,6,0,29
FRESNO COUNTY,MENDOTA PD,11,6,0,17
FRESNO COUNTY,ORANGE COVE PD,13,3,0,16
FRESNO COUNTY,PARLIER PD,18,1,0,19
FRESNO COUNTY,REEDLEY PD,29,2,7,38
FRESNO COUNTY,SANGER PD,36,1,0,37
FRESNO COUNTY,SELMA PD,30,0,7,37
FRESNO COUNTY,STATE CENTER CCD PD,20,0,6,26
GLENN COUNTY,GLENN CO DA,1,0,0,1
GLENN COUNTY,GLENN CO SO/CORONER,42,5,7,54
GLENN COUNTY,ORLAND PD,11,0,0,11
HUMBOLDT COUNTY,ARCATA PD,22,0,7,29
HUMBOLDT COUNTY,CSU HUMBOLDT PD,8,2,4,14
HUMBOLDT COUNTY,EUREKA PD,36,3,9,48
HUMBOLDT COUNTY,FERNDALE PD,6,4,0,10
HUMBOLDT COUNTY,FORTUNA PD,18,0,5,23
HUMBOLDT COUNTY,HUMBOLDT CO DA,10,0,0,10
HUMBOLDT COUNTY,HUMBOLDT CO SO,187,12,13,212
HUMBOLDT COUNTY,HUMBOLDT DEPT WELFARE/INVEST,9,0,0,9
HUMBOLDT COUNTY,RIO DELL PD,5,1,0,6
IMPERIAL COUNTY,BRAWLEY PD,25,5,8,38
IMPERIAL COUNTY,CALEXICO PD,23,2,8,33
IMPERIAL COUNTY,CALIPATRIA PD,5,3,0,8
IMPERIAL COUNTY,EL CENTRO PD,43,2,9,54
IMPERIAL COUNTY,IMPERIAL CO DA,17,0,0,17
IMPERIAL COUNTY,IMPERIAL CO SO,92,11,9,112
IMPERIAL COUNTY,IMPERIAL PD,18,0,0,18
IMPERIAL COUNTY,WESTMORLAND PD,5,5,0,10
INYO COUNTY,BISHOP PD,11,4,6,21
INYO COUNTY,INYO CO DA,3,0,0,3
INYO COUNTY,INYO COUNTY SO,35,8,6,49
KERN COUNTY,ARVIN PD,16,2,4,22
KERN COUNTY,BAKERSFIELD PD,427,10,41,478
KERN COUNTY,BEAR VALLEY PD,6,0,0,6
KERN COUNTY,CALIFORNIA CITY PD,13,5,5,23
KERN COUNTY,CSU BAKERSFIELD DPS,15,0,6,21
KERN COUNTY,DELANO PD,45,3,8,56
KERN COUNTY,KERN CO DA,28,0,0,28
KERN COUNTY,KERN CO-DEPT OF PARKS & REC,5,0,0,5
KERN COUNTY,KERN COUNTY SO,739,22,43,804
KERN COUNTY,KERN HIGH SCHOOL DISTRICT PD,32,0,2,34
KERN COUNTY,MCFARLAND PD,16,2,4,22
KERN COUNTY,RIDGECREST PD,24,10,4,38
KERN COUNTY,SHAFTER PD,29,1,8,38
KERN COUNTY,STALLION SPRINGS PD,5,2,0,7
KERN COUNTY,TAFT PD,12,1,5,18
KERN COUNTY,TEHACHAPI PD,17,1,7,25
KINGS COUNTY,AVENAL PD,15,2,0,17
KINGS COUNTY,CORCORAN PD,18,1,8,27
KINGS COUNTY,HANFORD PD,60,0,15,75
KINGS COUNTY,KINGS CO DA,13,0,0,13
KINGS COUNTY,KINGS CO SHERIFF'S OFFICE,197,4,15,216
KINGS COUNTY,"KINGS CO-HUMAN SVCS,WELFARE FD",4,0,0,4
KINGS COUNTY,LEMOORE PD,32,4,0,36
LAKE COUNTY,CLEARLAKE PD,21,0,6,27
LAKE COUNTY,LAKE CO DA,7,0,0,7
LAKE COUNTY,LAKE CO SO,90,1,6,97
LAKE COUNTY,LAKEPORT PD,9,2,0,11
LASSEN COUNTY,LASSEN CO DA,2,0,0,2
LASSEN COUNTY,LASSEN CO SO,52,3,6,61
LASSEN COUNTY,SUSANVILLE PD,15,3,0,18
LOS ANGELES COUNTY,ALHAMBRA PD,77,2,12,91
LOS ANGELES COUNTY,ARCADIA PD,63,5,9,77
LOS ANGELES COUNTY,AZUSA PD,54,2,9,65
LOS ANGELES COUNTY,BALDWIN PARK PD,58,0,10,68
LOS ANGELES COUNTY,BELL GARDENS PD,45,1,7,53
LOS ANGELES COUNTY,BELL PD,30,3,4,37
LOS ANGELES COUNTY,BEVERLY HILLS PD,132,8,20,160
LOS ANGELES COUNTY,BURBANK AIRPORT AUTH PD,39,0,0,39
LOS ANGELES COUNTY,BURBANK PD,149,12,19,180
LOS ANGELES COUNTY,CA DEPT INDUSTRIAL RELATIONS,3,0,0,3
LOS ANGELES COUNTY,CERRITOS CCD PD,12,0,0,12
LOS ANGELES COUNTY,CLAREMONT PD,36,4,8,48
LOS ANGELES COUNTY,COMPTON CCD PD,6,0,2,8
LOS ANGELES COUNTY,COMPTON UNIF SCH DIST PD,15,0,0,15
LOS ANGELES COUNTY,COVINA PD,58,1,5,64
LOS ANGELES COUNTY,CSU DOMINGUEZ HILLS PD,17,0,8,25
LOS ANGELES COUNTY,CSU LONG BEACH PD,19,0,8,27
LOS ANGELES COUNTY,CSU LOS ANGELES DPS,18,0,4,22
LOS ANGELES COUNTY,CSU NORTHRIDGE DEPT POLICE SVS,16,0,5,21
LOS ANGELES COUNTY,CSU POMONA DPS,19,0,6,25
LOS ANGELES COUNTY,CULVER CITY PD,100,13,0,113
LOS ANGELES COUNTY,DOWNEY PD,112,0,14,126
LOS ANGELES COUNTY,EL CAMINO CCD PD,12,1,4,17
LOS ANGELES COUNTY,EL MONTE PD,108,3,15,126
LOS ANGELES COUNTY,EL SEGUNDO PD,56,0,0,56
LOS ANGELES COUNTY,GARDENA PD,85,3,0,88
LOS ANGELES COUNTY,GLENDALE CCD PD,9,0,0,9
LOS ANGELES COUNTY,GLENDALE PD,235,12,23,270
LOS ANGELES COUNTY,GLENDORA PD,49,3,10,62
LOS ANGELES COUNTY,HACIENDA LA PUENTE USD,5,0,0,5
LOS ANGELES COUNTY,HAWTHORNE PD,90,2,0,92
LOS ANGELES COUNTY,HERMOSA BEACH PD,38,1,0,39
LOS ANGELES COUNTY,HUNTINGTON PARK PD,51,4,9,64
LOS ANGELES COUNTY,INGLEWOOD PD,174,0,21,195
LOS ANGELES COUNTY,IRWINDALE PD,30,2,6,38
LOS ANGELES COUNTY,LA VERNE PD,41,3,8,52
LOS ANGELES COUNTY,LONG BEACH DISASTER/EMERG COMM,0,0,46,46
LOS ANGELES COUNTY,LONG BEACH PD,724,21,0,745
LOS ANGELES COUNTY,LOS ANGELES CITY PARK RANGER,25,0,0,25
LOS ANGELES COUNTY,LOS ANGELES CO CORONER,54,0,0,54
LOS ANGELES COUNTY,LOS ANGELES CO DA,208,0,0,208
LOS ANGELES COUNTY,LOS ANGELES CO SD,9262,482,455,10199
LOS ANGELES COUNTY,LOS ANGELES PD,9299,393,614,10306
LOS ANGELES COUNTY,LOS ANGELES PORT PD,129,0,8,137
LOS ANGELES COUNTY,LOS ANGELES SCHOOL PD,233,0,0,233
LOS ANGELES COUNTY,LOS ANGELES WORLD AIRPORTS PD,464,0,0,464
LOS ANGELES COUNTY,MANHATTAN BEACH PD,58,1,0,59
LOS ANGELES COUNTY,MONROVIA PD,46,0,12,58
LOS ANGELES COUNTY,MONTEBELLO PD,64,6,6,76
LOS ANGELES COUNTY,MONTEBELLO UNIFIED SCHOOL DIST,2,0,0,2
LOS ANGELES COUNTY,MONTEREY PARK PD,70,10,12,92
LOS ANGELES COUNTY,PALOS VERDES ESTATES PD,19,5,7,31
LOS ANGELES COUNTY,PASADENA CITY CCD PD,10,0,10,20
LOS ANGELES COUNTY,PASADENA PD,215,7,30,252
LOS ANGELES COUNTY,POMONA PD,151,6,28,185
LOS ANGELES COUNTY,REDONDO BEACH PD,85,10,10,105
LOS ANGELES COUNTY,SAN FERNANDO PD,29,15,8,52
LOS ANGELES COUNTY,SAN GABRIEL PD,43,3,6,52
LOS ANGELES COUNTY,SAN MARINO PD,30,0,6,36
LOS ANGELES COUNTY,SANTA MONICA CCD PD,15,0,6,21
LOS ANGELES COUNTY,SANTA MONICA OFFICE EMER MGT,0,0,27,27
LOS ANGELES COUNTY,SANTA MONICA PD,201,0,0,201
LOS ANGELES COUNTY,SIERRA MADRE PD,17,5,9,31
LOS ANGELES COUNTY,SIGNAL HILL PD,31,0,5,36
LOS ANGELES COUNTY,SOUTH BAY REG PUB COMM AUTH,0,0,50,50
LOS ANGELES COUNTY,SOUTH GATE PD,72,1,10,83
LOS ANGELES COUNTY,SOUTH PASADENA PD,31,2,8,41
LOS ANGELES COUNTY,TORRANCE PD,200,0,22,222
LOS ANGELES COUNTY,UC LOS ANGELES PD,59,0,14,73
LOS ANGELES COUNTY,VERNON PD,42,1,7,50
LOS ANGELES COUNTY,WEST COVINA PD,97,4,16,117
LOS ANGELES COUNTY,WHITTIER PD,124,1,13,138
MADERA COUNTY,CHOWCHILLA PD,19,1,7,27
MADERA COUNTY,MADERA CO DA,9,0,0,9
MADERA COUNTY,MADERA CO SO,111,24,11,146
MADERA COUNTY,MADERA PD,63,1,12,76
MARIN COUNTY,BELVEDERE PD,6,1,0,7
MARIN COUNTY,CENTRAL MARIN POLICE AUTHORITY,39,2,1,42
MARIN COUNTY,FAIRFAX PD,10,1,4,15
MARIN COUNTY,MARIN CCD PD,5,0,0,5
MARIN COUNTY,MARIN CO DA,10,0,0,10
MARIN COUNTY,MARIN CO HEALTH & HUMAN SVCS,4,0,0,4
MARIN COUNTY,MARIN CO SO,188,0,40,228
MARIN COUNTY,MARIN MUNCPL WATER DIST,6,0,0,6
MARIN COUNTY,MILL VALLEY PD,20,1,0,21
MARIN COUNTY,NOVATO PD,54,0,10,64
MARIN COUNTY,ROSS PD,5,1,0,6
MARIN COUNTY,SAN RAFAEL PD,67,2,19,88
MARIN COUNTY,SAUSALITO PD,17,0,0,17
MARIN COUNTY,TIBURON PD,12,4,0,16
MARIPOSA COUNTY,MARIPOSA CO DA,1,0,0,1
MARIPOSA COUNTY,MARIPOSA CO SO,62,12,0,74
MENDOCINO COUNTY,FORT BRAGG PD,15,0,0,15
MENDOCINO COUNTY,MENDOCINO CO DA,7,0,0,7
MENDOCINO COUNTY,MENDOCINO CO HEALTH/HUMAN SVCS,6,0,0,6
MENDOCINO COUNTY,MENDOCINO CO SO,113,3,13,129
MENDOCINO COUNTY,UKIAH PD,24,0,11,35
MENDOCINO COUNTY,WILLITS PD,8,0,4,12
MERCED COUNTY,ATWATER PD,24,3,5,32
MERCED COUNTY,DOS PALOS PD,10,3,4,17
MERCED COUNTY,GUSTINE PD,7,8,0,15
MERCED COUNTY,LIVINGSTON PD,17,2,8,27
MERCED COUNTY,LOS BANOS PD,38,1,11,50
MERCED COUNTY,MERCED CCD PD,5,0,0,5
MERCED COUNTY,MERCED CO DA,9,0,0,9
MERCED COUNTY,MERCED CO SO,118,39,14,171
MERCED COUNTY,MERCED PD,90,5,14,109
MERCED COUNTY,UC MERCED PD,17,0,7,24
MODOC COUNTY,ALTURAS PD,7,0,0,7
MODOC COUNTY,MODOC CO SO,11,1,6,18
MONO COUNTY,MAMMOTH LAKES PD,14,0,0,14
MONO COUNTY,MONO CO DA,2,0,0,2
MONO COUNTY,MONO CO SD,36,0,14,50
MONTEREY COUNTY,CARMEL PD,12,0,3,15
MONTEREY COUNTY,CSU MONTEREY BAY PD,16,0,0,16
MONTEREY COUNTY,DEL REY OAKS PD,11,8,0,19
MONTEREY COUNTY,GONZALES PD,12,0,0,12
MONTEREY COUNTY,GREENFIELD PD,19,0,0,19
MONTEREY COUNTY,KING CITY PD,17,0,0,17
MONTEREY COUNTY,MARINA PD,29,0,0,29
MONTEREY COUNTY,MONTEREY CO DA,26,0,0,26
MONTEREY COUNTY,MONTEREY CO EMER COMM,0,0,62,62
MONTEREY COUNTY,MONTEREY CO SHERIFF'S OFFICE,277,4,0,281
MONTEREY COUNTY,MONTEREY PD,48,1,0,49
MONTEREY COUNTY,PACIFIC GROVE PD,21,0,0,21
MONTEREY COUNTY,SALINAS PD,138,0,0,138
MONTEREY COUNTY,SAND CITY PD,10,2,0,12
MONTEREY COUNTY,SEASIDE PD,28,0,0,28
MONTEREY COUNTY,SOLEDAD PD,18,4,0,22
NAPA COUNTY,CALISTOGA PD,11,0,7,18
NAPA COUNTY,NAPA CO DA,12,0,0,12
NAPA COUNTY,NAPA CO SO,103,0,0,103
NAPA COUNTY,NAPA PD,64,0,25,89
NAPA COUNTY,NAPA VALLEY COLLEGE DPS,5,0,0,5
NAPA COUNTY,SAINT HELENA PD,12,1,6,19
NEVADA COUNTY,GRASS VALLEY PD,27,5,0,32
NEVADA COUNTY,NEVADA CITY PD,10,3,0,13
NEVADA COUNTY,NEVADA CO DA,5,0,0,5
NEVADA COUNTY,NEVADA CO SO,62,3,13,78
NEVADA COUNTY,TRUCKEE PD,22,0,0,22
ORANGE COUNTY,ANAHEIM PD,369,23,31,423
ORANGE COUNTY,BREA PD,57,0,12,69
ORANGE COUNTY,BUENA PARK PD,79,4,14,97
ORANGE COUNTY,COAST CCD PD,1,0,0,1
ORANGE COUNTY,COSTA MESA PD,130,3,26,159
ORANGE COUNTY,CSU FULLERTON PD,24,0,9,33
ORANGE COUNTY,CYPRESS PD,52,0,0,52
ORANGE COUNTY,FOUNTAIN VALLEY PD,61,0,11,72
ORANGE COUNTY,FULLERTON PD,114,2,13,129
ORANGE COUNTY,GARDEN GROVE PD,172,8,21,201
ORANGE COUNTY,HUNTINGTON BEACH PD,204,2,21,227
ORANGE COUNTY,IRVINE PD,225,1,21,247
ORANGE COUNTY,IRVINE VALLEY CCD PD,9,0,5,14
ORANGE COUNTY,LA HABRA PD,70,6,15,91
ORANGE COUNTY,LA PALMA PD,20,5,7,32
ORANGE COUNTY,LAGUNA BEACH PD,54,3,14,71
ORANGE COUNTY,LOS ALAMITOS PD,21,2,0,23
ORANGE COUNTY,NEWPORT BEACH PD,134,2,18,154
ORANGE COUNTY,ORANGE CO DA,172,0,0,172
ORANGE COUNTY,ORANGE CO SD/CORONER,1862,104,47,2013
ORANGE COUNTY,ORANGE PD,153,4,18,175
ORANGE COUNTY,PLACENTIA PD,47,1,0,48
ORANGE COUNTY,PLACENTIA PUBLIC SAFETY COMM,0,0,12,12
ORANGE COUNTY,SADDLEBACK CCD PD,6,0,2,8
ORANGE COUNTY,SANTA ANA PD,350,4,37,391
ORANGE COUNTY,SANTA ANA UNIF SCHL DIST PD,24,0,0,24
ORANGE COUNTY,SEAL BEACH PD,40,0,0,40
ORANGE COUNTY,TUSTIN PD,96,5,13,114
ORANGE COUNTY,UC IRVINE PD,46,0,8,54
ORANGE COUNTY,WEST CITIES COMM CTR,0,0,18,18
ORANGE COUNTY,WESTMINSTER PD,82,4,12,98
PLACER COUNTY,AUBURN PD,21,3,7,31
PLACER COUNTY,LINCOLN PD,27,0,8,35
PLACER COUNTY,PLACER CO DA,19,0,0,19
PLACER COUNTY,PLACER COUNTY SO,247,83,24,354
PLACER COUNTY,ROCKLIN PD,60,2,14,76
PLACER COUNTY,ROSEVILLE PD,129,2,23,154
PLACER COUNTY,UNION PACIFIC RAILROAD,31,0,0,31
PLUMAS COUNTY,PLUMAS CO SO,30,4,7,41
RIVERSIDE COUNTY,BANNING PD,33,2,8,43
RIVERSIDE COUNTY,BEAUMONT PD,50,0,12,62
RIVERSIDE COUNTY,BLYTHE PD,20,0,7,27
RIVERSIDE COUNTY,CATHEDRAL CITY PD,50,1,18,69
RIVERSIDE COUNTY,CORONA PD,152,0,19,171
RIVERSIDE COUNTY,DESERT HOT SPRINGS PD,29,1,6,36
RIVERSIDE COUNTY,HEMET PD,62,0,11,73
RIVERSIDE COUNTY,INDIO PD,61,0,12,73
RIVERSIDE COUNTY,MENIFEE PD,76,1,0,77
RIVERSIDE COUNTY,MURRIETA PD,99,2,39,140
RIVERSIDE COUNTY,PALM SPRINGS PD,98,2,16,116
RIVERSIDE COUNTY,RIVERSIDE CCD PD,18,0,0,18
RIVERSIDE COUNTY,RIVERSIDE CO DA,119,0,2,121
RIVERSIDE COUNTY,RIVERSIDE CO PUBLIC SOCIAL SER,22,0,0,22
RIVERSIDE COUNTY,RIVERSIDE CO SD,2802,33,157,2992
RIVERSIDE COUNTY,RIVERSIDE PD,349,0,53,402
RIVERSIDE COUNTY,UC RIVERSIDE PD,24,0,5,29
RIVERSIDE COUNTY,VAL VERDE UNIF SCH DIST PD,6,7,0,13
SACRAMENTO COUNTY,AMTRAK PD,30,0,0,30
SACRAMENTO COUNTY,CA ALCOHOLIC BEVERAGE CONTROL,180,0,0,180
SACRAMENTO COUNTY,CA ASSEMBLY SGT AT ARMS LEGIS,15,0,0,15
SACRAMENTO COUNTY,CA DEPT CONSUMER AFF DEN BD,9,0,0,9
SACRAMENTO COUNTY,CA DEPT CONSUMER AFF INVEST,125,0,0,125
SACRAMENTO COUNTY,CA DEPT DEVELOPMENTAL OPS,77,0,0,77
SACRAMENTO COUNTY,CA DEPT EMPLOYMENT DEVELOPMENT,34,0,0,34
SACRAMENTO COUNTY,CA DEPT FISH & WILDLIFE,368,0,0,368
SACRAMENTO COUNTY,CA DEPT HEALTH CARE SVCS,65,0,0,65
SACRAMENTO COUNTY,CA DEPT INSURANCE FRAUD,180,0,0,180
SACRAMENTO COUNTY,CA DEPT JUSTICE,274,0,0,274
SACRAMENTO COUNTY,CA DEPT MOTOR VEHICLES,214,0,0,214
SACRAMENTO COUNTY,CA DEPT PARKS & RECREATION,552,0,46,598
SACRAMENTO COUNTY,CA DEPT PUB HEALTH FOOD/DRUG,76,0,0,76
SACRAMENTO COUNTY,CA DEPT SOCIAL SERVICES,60,0,0,60
SACRAMENTO COUNTY,CA DEPT STATE HOSPITALS,59,0,0,59
SACRAMENTO COUNTY,CA DEPT TOXIC SUBSTANCES CNTL,10,0,0,10
SACRAMENTO COUNTY,CA FRANCHISE TAX BOARD,29,0,0,29
SACRAMENTO COUNTY,CA HIGHWAY PATROL,6637,0,830,7467
SACRAMENTO COUNTY,CA HORSE RACING BOARD,15,0,0,15
SACRAMENTO COUNTY,CA OFFICE OF LE SUPPORT (OLES),5,0,0,5
SACRAMENTO COUNTY,CA SECRETARY OF STATE OFC INV,3,0,0,3
SACRAMENTO COUNTY,CA STATE FAIR PD,2,1,0,3
SACRAMENTO COUNTY,CA STATE LOTTERY,35,0,0,35
SACRAMENTO COUNTY,CAL - OES,18,0,0,18
SACRAMENTO COUNTY,CAL FIRE,164,0,0,164
SACRAMENTO COUNTY,CITRUS HEIGHTS PD,81,4,22,107
SACRAMENTO COUNTY,CSU SACRAMENTO PD,20,0,7,27
SACRAMENTO COUNTY,"DEPT CANNABIS CNTL, ENF DIV",51,0,0,51
SACRAMENTO COUNTY,ELK GROVE PD,129,0,19,148
SACRAMENTO COUNTY,FOLSOM PD,73,3,15,91
SACRAMENTO COUNTY,GALT PD,35,2,8,45
SACRAMENTO COUNTY,LOS RIOS CCD PD,12,0,6,18
SACRAMENTO COUNTY,SACRAMENTO CO CORONER,15,0,0,15
SACRAMENTO COUNTY,SACRAMENTO CO DA,41,0,0,41
SACRAMENTO COUNTY,SACRAMENTO CO HUMAN ASST INV,20,0,0,20
SACRAMENTO COUNTY,SACRAMENTO CO REG PARKS DEPT,26,1,0,27
SACRAMENTO COUNTY,SACRAMENTO CO SD,1314,390,78,1782
SACRAMENTO COUNTY,SACRAMENTO PD,674,88,82,844
SACRAMENTO COUNTY,TWIN RIVERS USD PD,14,4,5,23
SAN BENITO COUNTY,HOLLISTER PD,33,4,0,37
SAN BENITO COUNTY,SAN BENITO CO DA,3,0,0,3
SAN BENITO COUNTY,SAN BENITO CO SO,55,12,0,67
SAN BERNARDINO COUNTY,APPLE VALLEY UNIF SCH DIST PD,9,1,2,12
SAN BERNARDINO COUNTY,BARSTOW PD,40,1,8,49
SAN BERNARDINO COUNTY,BURLINGTON NORTHRN SANTA FE RR,33,0,0,33
SAN BERNARDINO COUNTY,CHAFFEY CCD PD,12,0,0,12
SAN BERNARDINO COUNTY,CHINO PD,115,1,18,134
SAN BERNARDINO COUNTY,COLTON PD,53,0,11,64
SAN BERNARDINO COUNTY,CSU SAN BERNARDINO PD,11,0,7,18
SAN BERNARDINO COUNTY,FONTANA PD,189,9,26,224
SAN BERNARDINO COUNTY,FONTANA UNIFIED SCHOOL DIST,12,0,8,20
SAN BERNARDINO COUNTY,HESPERIA UNIFIED SCHOOL DIST,8,0,0,8
SAN BERNARDINO COUNTY,MONTCLAIR PD,46,4,8,58
SAN BERNARDINO COUNTY,ONTARIO PD,273,7,36,316
SAN BERNARDINO COUNTY,REDLANDS PD,78,1,13,92
SAN BERNARDINO COUNTY,RIALTO PD,111,1,13,125
SAN BERNARDINO COUNTY,SAN BERNARDINO CCD PD,10,0,1,11
SAN BERNARDINO COUNTY,SAN BERNARDINO CO DA,60,0,0,60
SAN BERNARDINO COUNTY,SAN BERNARDINO CO HUMAN SVCS,22,0,0,22
SAN BERNARDINO COUNTY,SAN BERNARDINO CO SD,1895,128,145,2168
SAN BERNARDINO COUNTY,SAN BERNARDINO PD,253,11,28,292
SAN BERNARDINO COUNTY,SAN BERNARDINO UNIF SCHL DIST,25,2,6,33
SAN BERNARDINO COUNTY,SNOWLINE JOINT UNIF SCHL DIST,2,3,0,5
SAN BERNARDINO COUNTY,UPLAND PD,65,4,15,84
SAN BERNARDINO COUNTY,VICTOR VALLEY COLLEGE PD,7,7,0,14
SAN DIEGO COUNTY,CA DEPT OF FIN PROT AND INNOV,5,0,0,5
SAN DIEGO COUNTY,CARLSBAD PD,123,1,17,141
SAN DIEGO COUNTY,CHULA VISTA PD,238,2,27,267
SAN DIEGO COUNTY,CORONADO PD,44,1,11,56
SAN DIEGO COUNTY,CSU SAN DIEGO PD,33,8,9,50
SAN DIEGO COUNTY,CSU SAN MARCOS PD,18,0,6,24
SAN DIEGO COUNTY,EL CAJON PD,123,20,19,162
SAN DIEGO COUNTY,ESCONDIDO PD,136,5,27,168
SAN DIEGO COUNTY,LA MESA PD,63,0,21,84
SAN DIEGO COUNTY,MIRA COSTA CCD PD,7,0,5,12
SAN DIEGO COUNTY,NATIONAL CITY PD,84,2,10,96
SAN DIEGO COUNTY,OCEANSIDE PD,201,1,26,228
SAN DIEGO COUNTY,PALOMAR CCD PD,11,4,0,15
SAN DIEGO COUNTY,SAN DIEGO CCD PD,36,0,10,46
SAN DIEGO COUNTY,SAN DIEGO CITY SCHOOLS PD,38,0,9,47
SAN DIEGO COUNTY,SAN DIEGO CO DA,119,0,0,119
SAN DIEGO COUNTY,SAN DIEGO CO PUBLIC ASST INV,37,0,0,37
SAN DIEGO COUNTY,SAN DIEGO CO SD,2492,95,132,2719
SAN DIEGO COUNTY,"SAN DIEGO HARBOR PD, PORT OF",116,0,9,125
SAN DIEGO COUNTY,SAN DIEGO PD,1787,14,154,1955
SAN DIEGO COUNTY,SOUTHWESTERN CCD PD,10,0,3,13
SAN DIEGO COUNTY,UC SAN DIEGO PD,38,0,9,47
SAN FRANCISCO COUNTY,CSU SAN FRANCISCO PD,17,0,2,19
SAN FRANCISCO COUNTY,SAN FRAN INT'L AIRPORT COMM,0,0,29,29
SAN FRANCISCO COUNTY,SAN FRANCISCO CCD PD,14,0,0,14
SAN FRANCISCO COUNTY,SAN FRANCISCO CO DA,36,0,0,36
SAN FRANCISCO COUNTY,SAN FRANCISCO CO MED EXAM,15,0,0,15
SAN FRANCISCO COUNTY,SAN FRANCISCO CO SO,759,0,0,759
SAN FRANCISCO COUNTY,SAN FRANCISCO DEPT EMER MGT,0,0,187,187
SAN FRANCISCO COUNTY,SAN FRANCISCO PD,1978,28,0,2006
SAN FRANCISCO COUNTY,UC SAN FRANCISCO PD,53,0,11,64
SAN JOAQUIN COUNTY,ESCALON PD,11,13,0,24
SAN JOAQUIN COUNTY,LODI PD,66,2,17,85
SAN JOAQUIN COUNTY,MANTECA PD,72,2,12,86
SAN JOAQUIN COUNTY,PORT OF STOCKTON PD,15,0,0,15
SAN JOAQUIN COUNTY,RIPON PD,24,0,10,34
SAN JOAQUIN COUNTY,SAN JOAQUIN CO DA,42,0,0,42
SAN JOAQUIN COUNTY,SAN JOAQUIN CO SO,313,3,32,348
SAN JOAQUIN COUNTY,SAN JOAQUIN DELTA COLLEGE PD,11,1,4,16
SAN JOAQUIN COUNTY,STOCKTON PD,378,32,51,461
SAN JOAQUIN COUNTY,STOCKTON USD DEPT PUB SAFETY,26,0,9,35
SAN JOAQUIN COUNTY,TRACY PD,99,3,16,118
SAN LUIS OBISPO COUNTY,ARROYO GRANDE PD,25,0,0,25
SAN LUIS OBISPO COUNTY,ATASCADERO PD,32,0,6,38
SAN LUIS OBISPO COUNTY,CPSU SAN LUIS OBISPO PD,18,0,7,25
SAN LUIS OBISPO COUNTY,CUESTA CCD DPS,4,0,0,4
SAN LUIS OBISPO COUNTY,GROVER BEACH PD,19,1,3,23
SAN LUIS OBISPO COUNTY,MORRO BAY PD,17,0,0,17
SAN LUIS OBISPO COUNTY,PASO ROBLES PD,41,2,10,53
SAN LUIS OBISPO COUNTY,PISMO BEACH PD,22,1,9,32
SAN LUIS OBISPO COUNTY,SAN LUIS OBISPO CO DA,17,0,0,17
SAN LUIS OBISPO COUNTY,SAN LUIS OBISPO CO SO,307,12,21,340
SAN LUIS OBISPO COUNTY,SAN LUIS OBISPO PD,58,3,13,74
SAN MATEO COUNTY,ATHERTON PD,22,2,11,35
SAN MATEO COUNTY,BELMONT PD,31,0,8,39
SAN MATEO COUNTY,BRISBANE PD,13,0,0,13
SAN MATEO COUNTY,BROADMOOR PD,8,0,0,8
SAN MATEO COUNTY,BURLINGAME PD,36,0,14,50
SAN MATEO COUNTY,COLMA PD,18,0,5,23
SAN MATEO COUNTY,DALY CITY PD,93,0,0,93
SAN MATEO COUNTY,EAST PALO ALTO PD,27,0,0,27
SAN MATEO COUNTY,FOSTER CITY PD,34,4,9,47
SAN MATEO COUNTY,HILLSBOROUGH PD,26,2,5,33
SAN MATEO COUNTY,MENLO PARK PD,43,2,13,58
SAN MATEO COUNTY,PACIFICA PD,30,4,0,34
SAN MATEO COUNTY,REDWOOD CITY PD,85,2,16,103
SAN MATEO COUNTY,SAN BRUNO PD,46,4,12,62
SAN MATEO COUNTY,SAN MATEO CO CORONER,11,0,0,11
SAN MATEO COUNTY,SAN MATEO CO DA,14,0,0,14
SAN MATEO COUNTY,SAN MATEO CO PUB SFTY COMM CTR,0,0,71,71
SAN MATEO COUNTY,SAN MATEO CO SHERIFF'S OFFICE,287,33,0,320
SAN MATEO COUNTY,SAN MATEO PD,110,3,15,128
SAN MATEO COUNTY,SOUTH SAN FRANCISCO PD,80,0,17,97
SANTA BARBARA COUNTY,ALLAN HANCOCK CCD PD,5,2,2,9
SANTA BARBARA COUNTY,GUADALUPE PD,14,1,0,15
SANTA BARBARA COUNTY,LOMPOC PD,46,0,11,57
SANTA BARBARA COUNTY,SANTA BARBARA CO DA,14,0,0,14
SANTA BARBARA COUNTY,SANTA BARBARA CO SO,489,40,32,561
SANTA BARBARA COUNTY,SANTA BARBARA PD,112,12,12,136
SANTA BARBARA COUNTY,SANTA MARIA PD,101,0,19,120
SANTA BARBARA COUNTY,UC SANTA BARBARA PD,31,0,4,35
SANTA CLARA COUNTY,CAMPBELL PD,43,7,13,63
SANTA CLARA COUNTY,CSU SAN JOSE PD,21,0,8,29
SANTA CLARA COUNTY,FOOTHILL-DEANZA CCD PD,9,0,0,9
SANTA CLARA COUNTY,GILROY PD,62,4,11,77
SANTA CLARA COUNTY,LOS ALTOS PD,30,1,11,42
SANTA CLARA COUNTY,LOS GATOS PD,37,6,5,48
SANTA CLARA COUNTY,MILPITAS PD,87,1,14,102
SANTA CLARA COUNTY,MORGAN HILL PD,38,0,10,48
SANTA CLARA COUNTY,MOUNTAIN VIEW PD,86,9,18,113
SANTA CLARA COUNTY,PALO ALTO PD,67,6,17,90
SANTA CLARA COUNTY,SAN JOSE PD,1082,94,147,1323
SANTA CLARA COUNTY,SAN JOSE UNIF SCHL DIST PD,1,0,0,1
SANTA CLARA COUNTY,SAN JOSE/EVERGREEN CCD PD,7,1,0,8
SANTA CLARA COUNTY,SANTA CLARA CO COMM DEPT,0,0,81,81
SANTA CLARA COUNTY,SANTA CLARA CO DA,88,0,0,88
SANTA CLARA COUNTY,SANTA CLARA CO DA-WELFARE FRD,1,0,0,1
SANTA CLARA COUNTY,SANTA CLARA CO SO,1171,56,0,1227
SANTA CLARA COUNTY,SANTA CLARA PD,142,172,21,335
SANTA CLARA COUNTY,SUNNYVALE DPS,202,0,22,224
SANTA CLARA COUNTY,WEST VALLEY CCD PD,9,1,0,10
SANTA CRUZ COUNTY,CAPITOLA PD,21,2,0,23
SANTA CRUZ COUNTY,SANTA CRUZ CO DA,18,0,0,18
SANTA CRUZ COUNTY,SANTA CRUZ CO SO,144,17,0,161
SANTA CRUZ COUNTY,SANTA CRUZ PD,74,0,0,74
SANTA CRUZ COUNTY,SCOTTS VALLEY PD,18,4,7,29
SANTA CRUZ COUNTY,UC SANTA CRUZ PD,18,0,9,27
SANTA CRUZ COUNTY,WATSONVILLE PD,68,0,0,68
SHASTA COUNTY,ANDERSON PD,24,1,0,25
SHASTA COUNTY,REDDING PD,110,1,0,111
SHASTA COUNTY,SHASTA AREA SAFETY COMM AGCY,0,0,36,36
SHASTA COUNTY,SHASTA CO DA,10,0,0,10
SHASTA COUNTY,SHASTA CO MARSHAL,23,0,1,24
SHASTA COUNTY,SHASTA CO SO,120,6,0,126
SIERRA COUNTY,SIERRA CO SHERIFF'S OFFICE,10,2,5,17
SISKIYOU COUNTY,ETNA PD,5,2,0,7
SISKIYOU COUNTY,LAKE SHASTINA DISTRICT PD,4,0,0,4
SISKIYOU COUNTY,MOUNT SHASTA PD,9,2,6,17
SISKIYOU COUNTY,SISKIYOU CO DA,4,0,0,4
SISKIYOU COUNTY,SISKIYOU CO SD,59,10,9,78
SISKIYOU COUNTY,TULELAKE PD,3,0,0,3
SISKIYOU COUNTY,WEED PD,7,1,6,14
SISKIYOU COUNTY,YREKA PD,15,0,10,25
SOLANO COUNTY,BENICIA PD,30,2,13,45
SOLANO COUNTY,CSU CAL MARITIME ACADEMY PD,8,0,0,8
SOLANO COUNTY,DIXON PD,24,0,0,24
SOLANO COUNTY,FAIRFIELD PD,123,0,25,148
SOLANO COUNTY,SOLANO CCD DPS,2,0,0,2
SOLANO COUNTY,SOLANO CO DA,13,0,0,13
SOLANO COUNTY,SOLANO CO SO,172,9,21,202
SOLANO COUNTY,SOLANO CO SPECIAL INV BUREAU,7,0,0,7
SOLANO COUNTY,SUISUN CITY PD,25,2,8,35
SOLANO COUNTY,VACAVILLE PD,105,2,20,127
SOLANO COUNTY,VALLEJO PD,88,2,17,107
SONOMA COUNTY,CLOVERDALE PD,13,0,7,20
SONOMA COUNTY,COTATI PD,10,0,6,16
SONOMA COUNTY,CSU SONOMA PD,11,0,1,12
SONOMA COUNTY,HEALDSBURG PD,15,0,7,22
SONOMA COUNTY,PETALUMA PD,68,0,15,83
SONOMA COUNTY,ROHNERT PARK DPS,71,0,16,87
SONOMA COUNTY,SANTA ROSA PD,162,0,31,193
SONOMA COUNTY,SEBASTOPOL PD,12,3,4,19
SONOMA COUNTY,SONOMA CO DA,13,0,0,13
SONOMA COUNTY,"SONOMA CO HUM SRV,WLF FRD INV",6,0,0,6
SONOMA COUNTY,SONOMA CO JR COLLEGE DIST PD,10,0,5,15
SONOMA COUNTY,SONOMA CO SHERIFF'S OFFICE,400,0,24,424
SONOMA COUNTY,SONOMA-MARIN AREA RAIL TRANSIT,1,0,0,1
STANISLAUS COUNTY,CERES DPS,50,4,10,64
STANISLAUS COUNTY,CSU STANISLAUS DPS,14,0,2,16
STANISLAUS COUNTY,MODESTO PD,170,8,0,178
STANISLAUS COUNTY,NEWMAN PD,13,4,0,17
STANISLAUS COUNTY,OAKDALE PD,23,3,8,34
STANISLAUS COUNTY,STANISLAUS CO DA,19,0,0,19
STANISLAUS COUNTY,STANISLAUS CO SD,531,31,0,562
STANISLAUS COUNTY,STANISLAUS REGIONAL 9-1-1,0,0,39,39
STANISLAUS COUNTY,TURLOCK PD,82,0,14,96
SUTTER COUNTY,SUTTER CO DA,5,0,0,5
SUTTER COUNTY,SUTTER CO HEALTH & HUMAN SVCS,2,0,0,2
SUTTER COUNTY,SUTTER CO SO,99,8,10,117
SUTTER COUNTY,YUBA CITY PD,60,4,10,74
SUTTER COUNTY,CORNING PD,11,0,4,15
SUTTER COUNTY,RED BLUFF PD,25,3,10,38
SUTTER COUNTY,TEHAMA CO DA,6,0,0,6
SUTTER COUNTY,TEHAMA CO SO,63,8,8,79
TRINITY COUNTY,TRINITY CO DIST ATTORNEY,1,0,0,1
TRINITY COUNTY,TRINITY CO MARSHAL,4,0,0,4
TRINITY COUNTY,TRINITY COUNTY SO,36,5,0,41
TULARE COUNTY,COLLEGE OF THE SEQUOIAS PD,5,1,0,6
TULARE COUNTY,DINUBA PD,37,0,6,43
TULARE COUNTY,EXETER PD,15,5,0,20
TULARE COUNTY,FARMERSVILLE PD,16,0,0,16
TULARE COUNTY,LINDSAY DPS,17,1,0,18
TULARE COUNTY,PORTERVILLE PD,61,3,14,78
TULARE COUNTY,TULARE CO DA,39,0,0,39
TULARE COUNTY,TULARE CO SO,506,16,22,544
TULARE COUNTY,TULARE PD,67,0,13,80
TULARE COUNTY,VISALIA PD,146,0,26,172
TULARE COUNTY,WOODLAKE PD,14,1,0,15
TUOLUMNE COUNTY,SONORA PD,12,2,5,19
TUOLUMNE COUNTY,TUOLUMNE CO DA,3,0,0,3
TUOLUMNE COUNTY,TUOLUMNE CO SO,91,4,12,107
VENTURA COUNTY,CSU CHANNEL ISLANDS PD,13,0,5,18
VENTURA COUNTY,OXNARD PD,213,5,20,238
VENTURA COUNTY,PORT HUENEME PD,20,3,5,28
VENTURA COUNTY,SANTA PAULA PD,33,1,6,40
VENTURA COUNTY,SIMI VALLEY PD,114,0,18,132
VENTURA COUNTY,VENTURA CO CCD PD,14,0,0,14
VENTURA COUNTY,VENTURA CO DA,55,0,0,55
VENTURA COUNTY,VENTURA CO SO,703,12,37,752
VENTURA COUNTY,VENTURA PD,132,0,15,147
YOLO COUNTY,DAVIS PD,54,2,15,71
YOLO COUNTY,UC DAVIS PD,45,0,9,54
YOLO COUNTY,WEST SACRAMENTO PD,70,2,0,72
YOLO COUNTY,WINTERS PD,11,2,0,13
YOLO COUNTY,WOODLAND PD,67,0,0,67
YOLO COUNTY,YOLO CO COMM EMER,0,0,39,39
YOLO COUNTY,YOLO CO DA,15,0,0,15
YOLO COUNTY,YOLO CO SHERIFF'S OFFICE,81,5,0,86
YUBA COUNTY,MARYSVILLE PD,17,12,9,38
YUBA COUNTY,WHEATLAND PD,8,2,0,10
YUBA COUNTY,YUBA CO DA,2,0,0,2
YUBA COUNTY,YUBA CO SD,111,24,8,143
YUBA COUNTY,YUBA COMMUNITY COLL DIST PD,4,0,0,4
YUBA COUNTY,** GRAND TOTAL,82049,3680,7767,93496
