County,Agency,Sworn,Reserve,Dispatcher,Total
ALAMEDA COUNTY,ALAMEDA CO SD/CORONER,955,21,30,1006
ALAMEDA COUNTY,ALAMEDA PD,84,0,16,100
ALAMEDA COUNTY,ALAMEDA/CONTRA COSTA TRANSIT,1,0,0,1
ALAMEDA COUNTY,ALBANY PD,23,2,6,31
ALAMEDA COUNTY,BAY AREA RAPID TRANSIT PD,190,0,17,207
ALAMEDA COUNTY,BERKELEY PD,166,20,34,220
ALAMEDA COUNTY,CSU EAST BAY PD,14,0,5,19
ALAMEDA COUNTY,EAST BAY REG PARK DPS,56,1,16,73
ALAMEDA COUNTY,EMERYVILLE PD,35,0,16,51
ALAMEDA COUNTY,FREMONT PD,194,9,26,229
ALAMEDA COUNTY,HAYWARD PD,179,23,25,227
ALAMEDA COUNTY,LIVERMORE PD,88,6,21,115
ALAMEDA COUNTY,MORAGA PD,11,4,0,15
ALAMEDA COUNTY,NEWARK PD,56,4,13,73
ALAMEDA COUNTY,OAKLAND CITY HOUSING AUTH PD,31,3,0,34
ALAMEDA COUNTY,OAKLAND PD,730,11,63,804
ALAMEDA COUNTY,OAKLAND USD PD,13,0,0,13
ALAMEDA COUNTY,OHLONE CCD PD,2,0,0,2
ALAMEDA COUNTY,PIEDMONT PD,18,6,8,32
ALAMEDA COUNTY,PLEASANTON PD,79,1,17,97
ALAMEDA COUNTY,SAN LEANDRO PD,92,0,20,112
ALAMEDA COUNTY,UC BERKELEY PD,66,0,10,76
ALAMEDA COUNTY,UNION CITY PD,72,1,9,82
ALPINE COUNTY,ALPINE CO SD,10,1,1,12
AMADOR COUNTY,AMADOR CO DA,7,0,0,7
AMADOR COUNTY,AMADOR CO SD/CORONER,43,1,9,53
AMADOR COUNTY,IONE PD,7,2,0,9
AMADOR COUNTY,JACKSON PD,9,7,0,16
AMADOR COUNTY,SUTTER CREEK PD,4,2,0,6
BUTTE COUNTY,BUTTE CCD PD,5,1,0,6
BUTTE COUNTY,BUTTE CO DA,22,0,0,22
BUTTE COUNTY,BUTTE CO SD/CORONER,89,30,15,134
BUTTE COUNTY,CHICO PD,83,4,22,109
BUTTE COUNTY,CSU CHICO PD,14,0,6,20
BUTTE COUNTY,GRIDLEY PD,15,9,6,30
BUTTE COUNTY,OROVILLE PD,23,5,9,37
BUTTE COUNTY,PARADISE PD,21,0,10,31
CALAVERAS COUNTY,ANGELS CAMP PD,7,2,0,9
CALAVERAS COUNTY,CALAVERAS CO DA,2,0,0,2
CALAVERAS COUNTY,CALAVERAS CO SD,48,4,12,64
COLUSA COUNTY,COLUSA CO DISTRICT ATTORNEY,4,0,0,4
COLUSA COUNTY,COLUSA COUNTY SD,30,1,9,40
COLUSA COUNTY,COLUSA PD,7,1,0,8
COLUSA COUNTY,WILLIAMS PD,12,0,0,12
CONTRA COSTA COUNTY,ANTIOCH PD,87,4,15,106
CONTRA COSTA COUNTY,BRENTWOOD PD,64,0,0,64
CONTRA COSTA COUNTY,CLAYTON PD,11,1,0,12
CONTRA COSTA COUNTY,CONCORD PD,148,5,16,169
CONTRA COSTA COUNTY,CONTRA COSTA CCD PD,23,0,0,23
CONTRA COSTA COUNTY,CONTRA COSTA CO DA,29,0,0,29
CONTRA COSTA COUNTY,CONTRA COSTA CO SD/CORONER,616,37,49,702
CONTRA COSTA COUNTY,EL CERRITO PD,40,7,0,47
CONTRA COSTA COUNTY,HERCULES PD,21,3,0,24
CONTRA COSTA COUNTY,KENSINGTON PD,10,3,0,13
CONTRA COSTA COUNTY,MARTINEZ PD,34,5,13,52
CONTRA COSTA COUNTY,PINOLE PD,24,0,8,32
CONTRA COSTA COUNTY,PITTSBURG PD,76,4,0,80
CONTRA COSTA COUNTY,PLEASANT HILL PD,37,4,7,48
CONTRA COSTA COUNTY,RICHMOND PD,173,2,24,199
CONTRA COSTA COUNTY,SAN PABLO PD,48,0,0,48
CONTRA COSTA COUNTY,SAN RAMON PD,63,0,0,63
CONTRA COSTA COUNTY,WALNUT CREEK PD,81,28,15,124
DEL NORTE COUNTY,CRESCENT CITY PD,10,4,0,14
DEL NORTE COUNTY,DEL NORTE CO DA,2,0,0,2
DEL NORTE COUNTY,DEL NORTE COUNTY SD,22,5,5,32
EL DORADO COUNTY,EL DORADO CO DA,15,0,0,15
EL DORADO COUNTY,EL DORADO CO SD,154,6,20,180
EL DORADO COUNTY,PLACERVILLE PD,17,2,6,25
EL DORADO COUNTY,SOUTH LAKE TAHOE PD,34,7,8,49
FRESNO COUNTY,CLOVIS PD,95,14,21,130
FRESNO COUNTY,CLOVIS UNIF SCHL DIST PD,12,0,0,12
FRESNO COUNTY,COALINGA PD,20,6,6,32
FRESNO COUNTY,CSU FRESNO DPS,20,0,7,27
FRESNO COUNTY,FIREBAUGH PD,10,7,0,17
FRESNO COUNTY,FOWLER PD,12,4,0,16
FRESNO COUNTY,FRESNO CO DA,48,0,0,48
FRESNO COUNTY,FRESNO CO SD,387,60,45,492
FRESNO COUNTY,FRESNO PD,691,35,87,813
FRESNO COUNTY,FRESNO YOSEMITE INT'L AIRPORT,3,0,0,3
FRESNO COUNTY,HURON PD,4,10,5,19
FRESNO COUNTY,KERMAN PD,19,9,0,28
FRESNO COUNTY,KINGSBURG PD,12,7,6,25
FRESNO COUNTY,MENDOTA PD,11,7,0,18
FRESNO COUNTY,ORANGE COVE PD,11,3,0,14
FRESNO COUNTY,PARLIER PD,13,7,0,20
FRESNO COUNTY,REEDLEY PD,28,6,6,40
FRESNO COUNTY,SANGER PD,29,1,0,30
FRESNO COUNTY,SELMA PD,30,2,6,38
FRESNO COUNTY,STATE CENTER CCD PD,15,0,0,15
GLENN COUNTY,GLENN CO DA,2,0,0,2
GLENN COUNTY,GLENN CO SD/CORONER,23,4,10,37
GLENN COUNTY,ORLAND PD,9,1,1,11
GLENN COUNTY,WILLOWS PD,9,0,0,9
HUMBOLDT COUNTY,ARCATA PD,26,4,7,37
HUMBOLDT COUNTY,CSU HUMBOLDT DPS,10,0,7,17
HUMBOLDT COUNTY,EUREKA PD,50,8,10,68
HUMBOLDT COUNTY,FERNDALE PD,6,2,0,8
HUMBOLDT COUNTY,FORTUNA PD,15,3,7,25
HUMBOLDT COUNTY,HUMBOLDT CO DA,8,0,0,8
HUMBOLDT COUNTY,HUMBOLDT CO SD,175,16,10,201
HUMBOLDT COUNTY,HUMBOLDT DEPT WELFARE/INVEST,9,0,0,9
HUMBOLDT COUNTY,RIO DELL PD,5,2,0,7
IMPERIAL COUNTY,BRAWLEY PD,32,1,9,42
IMPERIAL COUNTY,CALEXICO PD,30,0,8,38
IMPERIAL COUNTY,CALIPATRIA PD,4,6,0,10
IMPERIAL COUNTY,EL CENTRO PD,50,4,9,63
IMPERIAL COUNTY,IMPERIAL CO DA,13,0,0,13
IMPERIAL COUNTY,IMPERIAL CO SD,100,9,12,121
IMPERIAL COUNTY,IMPERIAL PD,18,7,0,25
IMPERIAL COUNTY,WESTMORLAND PD,5,3,0,8
INYO COUNTY,BISHOP PD,12,4,5,21
INYO COUNTY,INYO CO DA,3,0,0,3
INYO COUNTY,INYO COUNTY SD,35,17,6,58
KERN COUNTY,ARVIN PD,17,4,5,26
KERN COUNTY,BAKERSFIELD PD,373,13,39,425
KERN COUNTY,BEAR VALLEY PD,7,0,8,15
KERN COUNTY,CALIFORNIA CITY PD,16,13,6,35
KERN COUNTY,CSU BAKERSFIELD DPS,11,0,4,15
KERN COUNTY,DELANO PD,49,2,5,56
KERN COUNTY,KERN CO DA,26,0,0,26
KERN COUNTY,KERN CO-DEPT OF PARKS & REC,6,1,0,7
KERN COUNTY,KERN COUNTY SD,888,53,37,978
KERN COUNTY,KERN HIGH SCHOOL DISTRICT PD,22,1,0,23
KERN COUNTY,MCFARLAND PD,14,1,4,19
KERN COUNTY,RIDGECREST PD,32,8,6,46
KERN COUNTY,SHAFTER PD,21,2,7,30
KERN COUNTY,STALLION SPRINGS PD,3,0,0,3
KERN COUNTY,TAFT PD,17,2,4,23
KERN COUNTY,TEHACHAPI PD,15,0,0,15
KINGS COUNTY,AVENAL PD,15,3,0,18
KINGS COUNTY,CORCORAN PD,16,2,7,25
KINGS COUNTY,HANFORD PD,52,1,16,69
KINGS COUNTY,KINGS CO DA,12,1,0,13
KINGS COUNTY,KINGS CO SHERIFF'S OFFICE,75,6,17,98
KINGS COUNTY,"KINGS CO-HUMAN SVCS,WELFARE FD",6,0,0,6
KINGS COUNTY,LEMOORE PD,30,6,0,36
LAKE COUNTY,CLEARLAKE PD,21,1,4,26
LAKE COUNTY,LAKE CO DA,5,0,1,6
LAKE COUNTY,LAKE CO SD,50,0,7,57
LAKE COUNTY,LAKEPORT PD,11,2,0,13
LASSEN COUNTY,LASSEN CO DA,1,0,0,1
LASSEN COUNTY,LASSEN CO SD,32,18,8,58
LASSEN COUNTY,SUSANVILLE PD,16,2,0,18
LOS ANGELES COUNTY,ALHAMBRA PD,86,9,15,110
LOS ANGELES COUNTY,ARCADIA PD,64,6,10,80
LOS ANGELES COUNTY,AZUSA PD,58,5,11,74
LOS ANGELES COUNTY,BALDWIN PARK PD,64,3,11,78
LOS ANGELES COUNTY,BELL GARDENS PD,50,0,5,55
LOS ANGELES COUNTY,BELL PD,28,6,4,38
LOS ANGELES COUNTY,BEVERLY HILLS PD,116,18,18,152
LOS ANGELES COUNTY,BURBANK AIRPORT AUTH PD,28,0,0,28
LOS ANGELES COUNTY,BURBANK PD,142,9,14,165
LOS ANGELES COUNTY,BURLINGTON NORTHRN SANTA FE RR,35,0,0,35
LOS ANGELES COUNTY,CA DEPT INDUSTRIAL RELATIONS,6,0,0,6
LOS ANGELES COUNTY,CA DEPT OF BUSINESS OVERSIGHT,4,0,0,4
LOS ANGELES COUNTY,CERRITOS CCD PD,11,0,0,11
LOS ANGELES COUNTY,CLAREMONT PD,38,3,7,48
LOS ANGELES COUNTY,COMPTON UNIF SCH DIST PD,24,0,0,24
LOS ANGELES COUNTY,COVINA PD,56,3,12,71
LOS ANGELES COUNTY,CSU DOMINGUEZ HILLS DPS,20,0,7,27
LOS ANGELES COUNTY,CSU LONG BEACH PD,22,0,9,31
LOS ANGELES COUNTY,CSU LOS ANGELES DPS,17,0,5,22
LOS ANGELES COUNTY,CSU NORTHRIDGE DEPT POLICE SVS,21,0,6,27
LOS ANGELES COUNTY,CSU POMONA DPS,17,0,5,22
LOS ANGELES COUNTY,CULVER CITY PD,102,17,11,130
LOS ANGELES COUNTY,DOWNEY PD,109,0,12,121
LOS ANGELES COUNTY,EL CAMINO CCD PD,24,2,7,33
LOS ANGELES COUNTY,EL MONTE PD,107,23,15,145
LOS ANGELES COUNTY,EL SEGUNDO PD,59,0,0,59
LOS ANGELES COUNTY,GARDENA PD,92,6,0,98
LOS ANGELES COUNTY,GLENDALE CCD PD,7,0,0,7
LOS ANGELES COUNTY,GLENDALE PD,235,13,23,271
LOS ANGELES COUNTY,GLENDORA PD,49,5,11,65
LOS ANGELES COUNTY,HACIENDA LA PUENTE USD,6,0,0,6
LOS ANGELES COUNTY,HAWTHORNE PD,94,6,0,100
LOS ANGELES COUNTY,HERMOSA BEACH PD,36,2,0,38
LOS ANGELES COUNTY,HUNTINGTON PARK PD,58,6,8,72
LOS ANGELES COUNTY,INGLEWOOD PD,170,1,19,190
LOS ANGELES COUNTY,INGLEWOOD UNIF SCH DIST PD,5,2,0,7
LOS ANGELES COUNTY,IRWINDALE PD,25,2,7,34
LOS ANGELES COUNTY,LA VERNE PD,38,19,8,65
LOS ANGELES COUNTY,LONG BEACH PD,792,38,64,894
LOS ANGELES COUNTY,LOS ANGELES CITY DPT GEN SVCS,6,0,9,15
LOS ANGELES COUNTY,LOS ANGELES CITY HOUSING AUTH,1,0,0,1
LOS ANGELES COUNTY,LOS ANGELES CITY PARK RANGER,11,0,0,11
LOS ANGELES COUNTY,LOS ANGELES CO CORONER,47,0,0,47
LOS ANGELES COUNTY,LOS ANGELES CO DA,271,0,0,271
LOS ANGELES COUNTY,LOS ANGELES CO SD,9217,785,485,10487
LOS ANGELES COUNTY,LOS ANGELES PD,9838,398,567,10803
LOS ANGELES COUNTY,LOS ANGELES PORT PD,128,2,6,136
LOS ANGELES COUNTY,LOS ANGELES SCHOOL PD,377,0,0,377
LOS ANGELES COUNTY,LOS ANGELES WORLD AIRPORTS PD,508,0,0,508
LOS ANGELES COUNTY,MANHATTAN BEACH PD,64,2,0,66
LOS ANGELES COUNTY,MONROVIA PD,46,4,9,59
LOS ANGELES COUNTY,MONTEBELLO PD,66,10,11,87
LOS ANGELES COUNTY,MONTEBELLO UNIFIED SCHOOL DIST,5,1,0,6
LOS ANGELES COUNTY,MONTEREY PARK PD,66,22,11,99
LOS ANGELES COUNTY,PALOS VERDES ESTATES PD,23,15,10,48
LOS ANGELES COUNTY,PASADENA CITY CCD PD,7,0,5,12
LOS ANGELES COUNTY,PASADENA PD,221,14,28,263
LOS ANGELES COUNTY,POMONA PD,153,11,30,194
LOS ANGELES COUNTY,REDONDO BEACH PD,94,15,15,124
LOS ANGELES COUNTY,SAN FERNANDO PD,26,22,8,56
LOS ANGELES COUNTY,SAN GABRIEL PD,49,5,5,59
LOS ANGELES COUNTY,SAN MARINO PD,27,0,6,33
LOS ANGELES COUNTY,SANTA MONICA CCD PD,12,0,6,18
LOS ANGELES COUNTY,SANTA MONICA PD,201,0,15,216
LOS ANGELES COUNTY,SIERRA MADRE PD,14,5,5,24
LOS ANGELES COUNTY,SIGNAL HILL PD,31,4,6,41
LOS ANGELES COUNTY,SOUTH BAY REG PUB COMM AUTH,0,0,51,51
LOS ANGELES COUNTY,SOUTH GATE PD,75,2,9,86
LOS ANGELES COUNTY,SOUTH PASADENA PD,31,9,7,47
LOS ANGELES COUNTY,TORRANCE PD,215,0,24,239
LOS ANGELES COUNTY,UC LOS ANGELES PD,59,0,13,72
LOS ANGELES COUNTY,UNION PACIFIC RAILROAD,63,0,0,63
LOS ANGELES COUNTY,VERNON PD,40,0,9,49
LOS ANGELES COUNTY,WEST COVINA PD,90,7,14,111
LOS ANGELES COUNTY,WHITTIER PD,116,4,11,131
MADERA COUNTY,CHOWCHILLA PD,15,3,8,26
MADERA COUNTY,MADERA CO DA,8,0,0,8
MADERA COUNTY,MADERA CO SD,76,27,10,113
MADERA COUNTY,MADERA PD,54,0,11,65
MARIN COUNTY,BELVEDERE PD,7,0,0,7
MARIN COUNTY,CENTRAL MARIN POLICE AUTHORITY,44,3,13,60
MARIN COUNTY,FAIRFAX PD,10,2,5,17
MARIN COUNTY,MARIN CCD PD,7,0,0,7
MARIN COUNTY,MARIN CO DA,8,0,0,8
MARIN COUNTY,MARIN CO SD,212,0,44,256
MARIN COUNTY,MARIN MUNCPL WATER DIST,6,0,0,6
MARIN COUNTY,MILL VALLEY PD,20,2,0,22
MARIN COUNTY,NOVATO PD,56,0,11,67
MARIN COUNTY,ROSS PD,8,2,0,10
MARIN COUNTY,SAN RAFAEL PD,64,4,15,83
MARIN COUNTY,SAUSALITO PD,19,0,0,19
MARIN COUNTY,TIBURON PD,14,6,0,20
MARIPOSA COUNTY,MARIPOSA CO DA,1,0,0,1
MARIPOSA COUNTY,MARIPOSA CO SD,37,12,0,49
MENDOCINO COUNTY,FORT BRAGG PD,15,0,0,15
MENDOCINO COUNTY,MENDOCINO CO DA,6,0,0,6
MENDOCINO COUNTY,MENDOCINO CO HEALTH/HUMAN SVCS,5,0,0,5
MENDOCINO COUNTY,MENDOCINO CO SD,129,3,13,145
MENDOCINO COUNTY,UKIAH PD,32,0,11,43
MENDOCINO COUNTY,WILLITS PD,13,0,6,19
MERCED COUNTY,ATWATER PD,30,2,7,39
MERCED COUNTY,DOS PALOS PD,8,3,4,15
MERCED COUNTY,GUSTINE PD,10,0,0,10
MERCED COUNTY,LIVINGSTON PD,19,7,5,31
MERCED COUNTY,LOS BANOS PD,37,0,11,48
MERCED COUNTY,MERCED CCD PD,3,0,0,3
MERCED COUNTY,MERCED CO DA,9,0,0,9
MERCED COUNTY,MERCED CO SD,100,31,13,144
MERCED COUNTY,MERCED PD,82,12,13,107
MERCED COUNTY,UC MERCED PD,11,0,5,16
MODOC COUNTY,ALTURAS PD,6,3,0,9
MODOC COUNTY,MODOC CO DA,1,0,0,1
MODOC COUNTY,MODOC CO SD,13,0,2,15
MONO COUNTY,MAMMOTH LAKES PD,10,4,0,14
MONO COUNTY,MONO CO DA,2,0,0,2
MONO COUNTY,MONO CO SD,25,0,19,44
MONTEREY COUNTY,CARMEL PD,13,1,6,20
MONTEREY COUNTY,CSU MONTEREY BAY PD,14,0,0,14
MONTEREY COUNTY,DEL REY OAKS PD,6,10,0,16
MONTEREY COUNTY,GONZALES PD,10,0,0,10
MONTEREY COUNTY,GREENFIELD PD,17,0,0,17
MONTEREY COUNTY,KING CITY PD,14,1,0,15
MONTEREY COUNTY,MARINA PD,29,6,0,35
MONTEREY COUNTY,MONTEREY CO DA,28,0,0,28
MONTEREY COUNTY,MONTEREY CO EMER COMM,0,0,59,59
MONTEREY COUNTY,MONTEREY CO SHERIFF'S OFFICE,296,11,0,307
MONTEREY COUNTY,MONTEREY PD,43,0,0,43
MONTEREY COUNTY,MONTEREY REG AIRPORT DIST PD,7,0,0,7
MONTEREY COUNTY,PACIFIC GROVE PD,17,4,0,21
MONTEREY COUNTY,SALINAS PD,136,12,0,148
MONTEREY COUNTY,SAND CITY PD,10,2,0,12
MONTEREY COUNTY,SEASIDE PD,34,2,0,36
MONTEREY COUNTY,SOLEDAD PD,17,8,0,25
NAPA COUNTY,CALISTOGA PD,9,0,6,15
NAPA COUNTY,NAPA CO DA,8,0,0,8
NAPA COUNTY,NAPA CO SD,100,0,0,100
NAPA COUNTY,NAPA PD,71,0,28,99
NAPA COUNTY,NAPA VALLEY COLLEGE DPS,3,0,0,3
NAPA COUNTY,NAPA VALLEY RR PD,1,0,0,1
NAPA COUNTY,SAINT HELENA PD,12,1,6,19
NEVADA COUNTY,GRASS VALLEY PD,24,7,0,31
NEVADA COUNTY,NEVADA CITY PD,9,5,0,14
NEVADA COUNTY,NEVADA CO DA,3,0,0,3
NEVADA COUNTY,NEVADA CO SD,60,5,12,77
NEVADA COUNTY,TRUCKEE PD,24,4,0,28
ORANGE COUNTY,ANAHEIM PD,372,6,37,415
ORANGE COUNTY,BREA PD,60,0,14,74
ORANGE COUNTY,BUENA PARK PD,80,8,20,108
ORANGE COUNTY,COSTA MESA PD,112,3,22,137
ORANGE COUNTY,CSU FULLERTON PD,28,0,9,37
ORANGE COUNTY,CYPRESS PD,48,0,0,48
ORANGE COUNTY,FOUNTAIN VALLEY PD,59,0,9,68
ORANGE COUNTY,FULLERTON PD,137,12,20,169
ORANGE COUNTY,GARDEN GROVE PD,155,25,17,197
ORANGE COUNTY,HUNTINGTON BEACH PD,209,10,25,244
ORANGE COUNTY,IRVINE PD,204,3,21,228
ORANGE COUNTY,IRVINE VALLEY CCD PD,7,0,4,11
ORANGE COUNTY,LA HABRA PD,66,8,17,91
ORANGE COUNTY,LA PALMA PD,21,4,6,31
ORANGE COUNTY,LAGUNA BEACH PD,46,4,10,60
ORANGE COUNTY,LOS ALAMITOS PD,23,2,0,25
ORANGE COUNTY,NEWPORT BEACH PD,141,8,19,168
ORANGE COUNTY,ORANGE CO DA,164,0,0,164
ORANGE COUNTY,ORANGE CO SD/CORONER,1837,195,53,2085
ORANGE COUNTY,ORANGE PD,146,10,16,172
ORANGE COUNTY,PLACENTIA PD,44,5,11,60
ORANGE COUNTY,SADDLEBACK CCD PD,7,0,2,9
ORANGE COUNTY,SANTA ANA PD,293,8,35,336
ORANGE COUNTY,SANTA ANA UNIF SCHL DIST PD,26,2,0,28
ORANGE COUNTY,SEAL BEACH PD,33,3,0,36
ORANGE COUNTY,TUSTIN PD,93,5,12,110
ORANGE COUNTY,UC IRVINE PD,29,0,8,37
ORANGE COUNTY,WEST CITIES COMM CTR,0,0,23,23
ORANGE COUNTY,WESTMINSTER PD,83,5,13,101
PLACER COUNTY,AUBURN PD,19,4,7,30
PLACER COUNTY,LINCOLN PD,22,2,6,30
PLACER COUNTY,PLACER CO DA,13,1,0,14
PLACER COUNTY,PLACER COUNTY SD,251,83,33,367
PLACER COUNTY,ROCKLIN PD,53,5,21,79
PLACER COUNTY,ROSEVILLE PD,122,3,23,148
PLUMAS COUNTY,PLUMAS CO SD,31,8,8,47
RIVERSIDE COUNTY,BANNING PD,25,5,9,39
RIVERSIDE COUNTY,BEAUMONT PD,41,0,14,55
RIVERSIDE COUNTY,BLYTHE PD,20,2,7,29
RIVERSIDE COUNTY,CATHEDRAL CITY PD,45,11,19,75
RIVERSIDE COUNTY,CORONA PD,158,0,25,183
RIVERSIDE COUNTY,DESERT HOT SPRINGS PD,23,2,0,25
RIVERSIDE COUNTY,HEMET PD,60,1,14,75
RIVERSIDE COUNTY,INDIO PD,62,0,14,76
RIVERSIDE COUNTY,MOUNT SAN JACINTO CCD PD,1,0,0,1
RIVERSIDE COUNTY,MURRIETA PD,86,5,21,112
RIVERSIDE COUNTY,PALM SPRINGS PD,78,7,18,103
RIVERSIDE COUNTY,RIVERSIDE CCD PD,19,6,0,25
RIVERSIDE COUNTY,RIVERSIDE CO DA,106,0,2,108
RIVERSIDE COUNTY,RIVERSIDE CO PUBLIC SOCIAL SER,24,0,0,24
RIVERSIDE COUNTY,RIVERSIDE CO SD,2082,50,183,2315
RIVERSIDE COUNTY,RIVERSIDE PD,358,5,47,410
RIVERSIDE COUNTY,UC RIVERSIDE PD,29,0,9,38
SACRAMENTO COUNTY,CA ALCOHOLIC BEVERAGE CONTROL,190,0,0,190
SACRAMENTO COUNTY,CA ASSEMBLY SGT AT ARMS LEGIS,23,0,0,23
SACRAMENTO COUNTY,CA DEPT CONSUMER AFF DEN BD,13,3,0,16
SACRAMENTO COUNTY,CA DEPT CONSUMER AFF INVEST,134,0,0,134
SACRAMENTO COUNTY,CA DEPT DEVELOPMENTAL OPS,82,0,0,82
SACRAMENTO COUNTY,CA DEPT EMPLOYMENT DEVELOPMENT,37,0,0,37
SACRAMENTO COUNTY,CA DEPT FISH & WILDLIFE,356,2,0,358
SACRAMENTO COUNTY,CA DEPT HEALTH CARE SVCS,85,0,0,85
SACRAMENTO COUNTY,CA DEPT INSURANCE FRAUD,184,0,0,184
SACRAMENTO COUNTY,CA DEPT JUSTICE,274,0,0,274
SACRAMENTO COUNTY,CA DEPT MOTOR VEHICLES,210,0,0,210
SACRAMENTO COUNTY,CA DEPT OF MANAGED HEALTH CARE,1,0,0,1
SACRAMENTO COUNTY,CA DEPT PARKS & RECREATION,545,0,51,596
SACRAMENTO COUNTY,CA DEPT PUB HEALTH FOOD/DRUG,98,0,0,98
SACRAMENTO COUNTY,CA DEPT SOCIAL SERVICES,59,0,0,59
SACRAMENTO COUNTY,CA DEPT STATE HOSPITALS,31,0,0,31
SACRAMENTO COUNTY,CA DEPT TOXIC SUBSTANCES CNTL,12,0,0,12
SACRAMENTO COUNTY,CA FRANCHISE TAX BOARD,41,0,0,41
SACRAMENTO COUNTY,CA HIGHWAY PATROL,7317,0,860,8177
SACRAMENTO COUNTY,CA HORSE RACING BOARD,11,0,0,11
SACRAMENTO COUNTY,CA SECRETARY OF STATE OFC INV,4,0,0,4
SACRAMENTO COUNTY,CA STATE CONTROLLER - INVEST,1,0,0,1
SACRAMENTO COUNTY,CA STATE FAIR PD,2,0,0,2
SACRAMENTO COUNTY,CA STATE LOTTERY,31,0,0,31
SACRAMENTO COUNTY,CAL - OES,10,0,0,10
SACRAMENTO COUNTY,CAL FIRE,178,0,0,178
SACRAMENTO COUNTY,CITRUS HEIGHTS PD,85,12,20,117
SACRAMENTO COUNTY,CSU SACRAMENTO DPS,22,0,5,27
SACRAMENTO COUNTY,ELK GROVE PD,128,11,22,161
SACRAMENTO COUNTY,FOLSOM PD,69,9,17,95
SACRAMENTO COUNTY,GALT PD,35,5,7,47
SACRAMENTO COUNTY,LOS RIOS CCD PD,29,3,6,38
SACRAMENTO COUNTY,SACRAMENTO CO CORONER,11,0,0,11
SACRAMENTO COUNTY,SACRAMENTO CO DA,40,0,0,40
SACRAMENTO COUNTY,SACRAMENTO CO HUMAN ASST INV,24,0,0,24
SACRAMENTO COUNTY,SACRAMENTO CO REG PARKS DEPT,17,4,0,21
SACRAMENTO COUNTY,SACRAMENTO CO SD,1313,362,54,1729
SACRAMENTO COUNTY,SACRAMENTO PD,647,87,75,809
SACRAMENTO COUNTY,TWIN RIVERS USD PD,22,3,4,29
SAN BENITO COUNTY,HOLLISTER PD,24,3,0,27
SAN BENITO COUNTY,SAN BENITO CO DA,2,0,0,2
SAN BENITO COUNTY,SAN BENITO CO SD,23,12,0,35
SAN BERNARDINO COUNTY,BARSTOW PD,36,1,10,47
SAN BERNARDINO COUNTY,CHAFFEY CCD PD,10,0,0,10
SAN BERNARDINO COUNTY,CHINO PD,98,1,19,118
SAN BERNARDINO COUNTY,COLTON PD,50,0,9,59
SAN BERNARDINO COUNTY,CSU SAN BERNARDINO DPS,15,0,14,29
SAN BERNARDINO COUNTY,FONTANA PD,181,1,27,209
SAN BERNARDINO COUNTY,FONTANA UNIFIED SCHOOL DIST,15,0,9,24
SAN BERNARDINO COUNTY,HESPERIA UNIFIED SCHOOL DIST,9,0,0,9
SAN BERNARDINO COUNTY,MONTCLAIR PD,47,5,13,65
SAN BERNARDINO COUNTY,ONTARIO PD,230,8,39,277
SAN BERNARDINO COUNTY,REDLANDS PD,79,6,17,102
SAN BERNARDINO COUNTY,RIALTO PD,101,2,13,116
SAN BERNARDINO COUNTY,SAN BERNARDINO CCD PD,6,0,1,7
SAN BERNARDINO COUNTY,SAN BERNARDINO CO DA,53,0,0,53
SAN BERNARDINO COUNTY,SAN BERNARDINO CO SD,1844,215,151,2210
SAN BERNARDINO COUNTY,SAN BERNARDINO PD,218,23,36,277
SAN BERNARDINO COUNTY,SAN BERNARDINO UNIF SCHL DIST,24,5,7,36
SAN BERNARDINO COUNTY,SNOWLINE JOINT UNIF SCHL DIST,2,2,0,4
SAN BERNARDINO COUNTY,UPLAND PD,65,4,17,86
SAN BERNARDINO COUNTY,VICTOR VALLEY COLLEGE PD,4,4,0,8
SAN DIEGO COUNTY,CARLSBAD PD,104,4,17,125
SAN DIEGO COUNTY,CHULA VISTA PD,209,11,27,247
SAN DIEGO COUNTY,CORONADO PD,41,2,8,51
SAN DIEGO COUNTY,CSU SAN DIEGO DPS,25,0,7,32
SAN DIEGO COUNTY,CSU SAN MARCOS DPS,16,0,5,21
SAN DIEGO COUNTY,EL CAJON PD,121,20,17,158
SAN DIEGO COUNTY,ESCONDIDO PD,156,8,22,186
SAN DIEGO COUNTY,LA MESA PD,61,2,15,78
SAN DIEGO COUNTY,MIRA COSTA CCD PD,9,0,3,12
SAN DIEGO COUNTY,NATIONAL CITY PD,82,11,12,105
SAN DIEGO COUNTY,OCEANSIDE PD,198,1,28,227
SAN DIEGO COUNTY,PALOMAR CCD PD,9,0,0,9
SAN DIEGO COUNTY,SAN DIEGO CCD PD,34,0,8,42
SAN DIEGO COUNTY,SAN DIEGO CITY SCHOOLS PD,43,0,9,52
SAN DIEGO COUNTY,SAN DIEGO CO DA,177,0,0,177
SAN DIEGO COUNTY,SAN DIEGO CO SD,2538,96,115,2749
SAN DIEGO COUNTY,"SAN DIEGO HARBOR PD, PORT OF",121,0,14,135
SAN DIEGO COUNTY,SAN DIEGO PD,1793,51,150,1994
SAN DIEGO COUNTY,SOUTHWESTERN CCD PD,9,0,0,9
SAN DIEGO COUNTY,UC SAN DIEGO PD,36,0,9,45
SAN FRANCISCO COUNTY,CSU SAN FRANCISCO PD,28,0,6,34
SAN FRANCISCO COUNTY,SAN FRAN INT'L AIRPORT COMM,0,0,35,35
SAN FRANCISCO COUNTY,SAN FRANCISCO CCD PD,25,0,1,26
SAN FRANCISCO COUNTY,SAN FRANCISCO CO DA,35,0,0,35
SAN FRANCISCO COUNTY,SAN FRANCISCO CO MED EXAM,11,0,0,11
SAN FRANCISCO COUNTY,SAN FRANCISCO CO SD,798,0,0,798
SAN FRANCISCO COUNTY,SAN FRANCISCO DEPT EMER MGT,0,0,193,193
SAN FRANCISCO COUNTY,SAN FRANCISCO MUNICIPAL RWY PD,3,0,0,3
SAN FRANCISCO COUNTY,SAN FRANCISCO PD,1971,42,0,2013
SAN FRANCISCO COUNTY,SUPREME COURT OF CALIFORNIA,1,0,0,1
SAN FRANCISCO COUNTY,UC SAN FRANCISCO PD,46,0,8,54
SAN JOAQUIN COUNTY,ESCALON PD,10,14,1,25
SAN JOAQUIN COUNTY,LODI PD,67,7,19,93
SAN JOAQUIN COUNTY,MANTECA PD,63,9,8,80
SAN JOAQUIN COUNTY,RIPON PD,23,1,7,31
SAN JOAQUIN COUNTY,SAN JOAQUIN CO DA,21,0,0,21
SAN JOAQUIN COUNTY,SAN JOAQUIN CO SD,306,10,33,349
SAN JOAQUIN COUNTY,SAN JOAQUIN DELTA COLLEGE PD,11,0,4,15
SAN JOAQUIN COUNTY,STOCKTON PD,369,33,45,447
SAN JOAQUIN COUNTY,STOCKTON UNIF SCHL DIST PD,22,0,9,31
SAN JOAQUIN COUNTY,TRACY PD,82,0,15,97
SAN LUIS OBISPO COUNTY,ARROYO GRANDE PD,26,2,0,28
SAN LUIS OBISPO COUNTY,ATASCADERO PD,27,1,8,36
SAN LUIS OBISPO COUNTY,CPSU SAN LUIS OBISPO PD,17,0,6,23
SAN LUIS OBISPO COUNTY,CUESTA CCD DPS,7,0,0,7
SAN LUIS OBISPO COUNTY,GROVER BEACH PD,15,1,6,22
SAN LUIS OBISPO COUNTY,MORRO BAY PD,17,0,0,17
SAN LUIS OBISPO COUNTY,PASO ROBLES PD,33,4,8,45
SAN LUIS OBISPO COUNTY,PISMO BEACH PD,22,2,6,30
SAN LUIS OBISPO COUNTY,SAN LUIS OBISPO CO DA,14,0,0,14
SAN LUIS OBISPO COUNTY,SAN LUIS OBISPO CO SD,282,12,21,315
SAN LUIS OBISPO COUNTY,SAN LUIS OBISPO PD,59,1,14,74
SAN MATEO COUNTY,ATHERTON PD,20,3,12,35
SAN MATEO COUNTY,BELMONT PD,31,2,11,44
SAN MATEO COUNTY,BRISBANE PD,16,0,0,16
SAN MATEO COUNTY,BROADMOOR PD,9,16,0,25
SAN MATEO COUNTY,BURLINGAME PD,36,4,19,59
SAN MATEO COUNTY,COLMA PD,19,0,5,24
SAN MATEO COUNTY,DALY CITY PD,106,0,19,125
SAN MATEO COUNTY,EAST PALO ALTO PD,34,0,0,34
SAN MATEO COUNTY,FOSTER CITY PD,33,6,12,51
SAN MATEO COUNTY,HILLSBOROUGH PD,23,1,7,31
SAN MATEO COUNTY,MENLO PARK PD,45,2,14,61
SAN MATEO COUNTY,PACIFICA PD,29,7,0,36
SAN MATEO COUNTY,REDWOOD CITY PD,91,6,11,108
SAN MATEO COUNTY,SAN BRUNO PD,47,3,8,58
SAN MATEO COUNTY,SAN MATEO CO CORONER,9,0,0,9
SAN MATEO COUNTY,SAN MATEO CO DA,14,0,0,14
SAN MATEO COUNTY,SAN MATEO CO PUB SFTY COMM CTR,0,0,60,60
SAN MATEO COUNTY,SAN MATEO CO SD,307,46,0,353
SAN MATEO COUNTY,SAN MATEO PD,115,8,19,142
SAN MATEO COUNTY,SOUTH SAN FRANCISCO PD,81,10,18,109
SANTA BARBARA COUNTY,ALLAN HANCOCK CCD PD,5,1,2,8
SANTA BARBARA COUNTY,GUADALUPE PD,10,3,1,14
SANTA BARBARA COUNTY,LOMPOC PD,49,0,13,62
SANTA BARBARA COUNTY,SANTA BARBARA CO DA,16,0,0,16
SANTA BARBARA COUNTY,SANTA BARBARA CO SD,452,37,25,514
SANTA BARBARA COUNTY,SANTA BARBARA PD,128,9,16,153
SANTA BARBARA COUNTY,SANTA MARIA PD,111,3,19,133
SANTA BARBARA COUNTY,UC SANTA BARBARA PD,38,0,7,45
SANTA CLARA COUNTY,CAMPBELL PD,40,15,14,69
SANTA CLARA COUNTY,CSU SAN JOSE PD,28,0,8,36
SANTA CLARA COUNTY,FOOTHILL-DEANZA CCD PD,12,0,0,12
SANTA CLARA COUNTY,GILROY PD,61,6,14,81
SANTA CLARA COUNTY,LOS ALTOS PD,32,4,8,44
SANTA CLARA COUNTY,LOS GATOS PD,39,7,7,53
SANTA CLARA COUNTY,MILPITAS PD,81,4,17,102
SANTA CLARA COUNTY,MORGAN HILL PD,37,4,9,50
SANTA CLARA COUNTY,MOUNTAIN VIEW EMERG COMM,0,0,16,16
SANTA CLARA COUNTY,MOUNTAIN VIEW PD,90,14,0,104
SANTA CLARA COUNTY,PALO ALTO PD,84,10,25,119
SANTA CLARA COUNTY,SAN JOSE PD,950,87,146,1183
SANTA CLARA COUNTY,SAN JOSE UNIF SCHL DIST PD,1,0,0,1
SANTA CLARA COUNTY,SAN JOSE/EVERGREEN CCD PD,4,3,1,8
SANTA CLARA COUNTY,SANTA CLARA CO COMM DEPT,0,0,77,77
SANTA CLARA COUNTY,SANTA CLARA CO DA,76,0,0,76
SANTA CLARA COUNTY,SANTA CLARA CO DA-WELFARE FRD,2,0,0,2
SANTA CLARA COUNTY,SANTA CLARA CO SD,452,71,0,523
SANTA CLARA COUNTY,SANTA CLARA PD,147,156,17,320
SANTA CLARA COUNTY,SUNNYVALE DPS,182,0,26,208
SANTA CLARA COUNTY,WEST VALLEY CCD PD,8,1,0,9
SANTA CRUZ COUNTY,CAPITOLA PD,21,2,0,23
SANTA CRUZ COUNTY,SANTA CRUZ CO DA,13,0,0,13
SANTA CRUZ COUNTY,SANTA CRUZ CO SD,139,15,0,154
SANTA CRUZ COUNTY,SANTA CRUZ PD,87,1,0,88
SANTA CRUZ COUNTY,SCOTTS VALLEY PD,20,7,7,34
SANTA CRUZ COUNTY,UC SANTA CRUZ PD,17,0,9,26
SANTA CRUZ COUNTY,WATSONVILLE PD,67,0,0,67
SHASTA COUNTY,ANDERSON PD,19,0,0,19
SHASTA COUNTY,REDDING PD,97,0,1,98
SHASTA COUNTY,SHASTA AREA SAFETY COMM AGCY,0,0,39,39
SHASTA COUNTY,SHASTA CO DA,10,0,0,10
SHASTA COUNTY,SHASTA CO MARSHAL,19,0,2,21
SHASTA COUNTY,SHASTA CO SD,90,5,0,95
SIERRA COUNTY,SIERRA CO SD,10,1,0,11
SISKIYOU COUNTY,ETNA PD,2,2,0,4
SISKIYOU COUNTY,LAKE SHASTINA DISTRICT PD,3,0,0,3
SISKIYOU COUNTY,MOUNT SHASTA PD,7,3,3,13
SISKIYOU COUNTY,SISKIYOU CO DA,2,0,0,2
SISKIYOU COUNTY,SISKIYOU CO SD,79,4,10,93
SISKIYOU COUNTY,TULELAKE PD,2,0,0,2
SISKIYOU COUNTY,WEED PD,7,2,7,16
SISKIYOU COUNTY,YREKA PD,14,1,4,19
SOLANO COUNTY,BENICIA PD,27,0,12,39
SOLANO COUNTY,CSU CAL MARITIME ACADEMY PD,10,0,0,10
SOLANO COUNTY,DIXON PD,20,5,0,25
SOLANO COUNTY,FAIRFIELD PD,113,0,19,132
SOLANO COUNTY,RIO VISTA PD,11,3,0,14
SOLANO COUNTY,SOLANO CCD PD,1,0,0,1
SOLANO COUNTY,SOLANO CO DA,9,0,0,9
SOLANO COUNTY,SOLANO CO SD,122,14,16,152
SOLANO COUNTY,SUISUN CITY PD,22,2,7,31
SOLANO COUNTY,VACAVILLE PD,95,3,18,116
SOLANO COUNTY,VALLEJO PD,108,4,22,134
SONOMA COUNTY,CLOVERDALE PD,11,2,7,20
SONOMA COUNTY,COTATI PD,10,2,6,18
SONOMA COUNTY,CSU SONOMA PD,13,0,6,19
SONOMA COUNTY,HEALDSBURG PD,17,0,7,24
SONOMA COUNTY,PETALUMA PD,61,0,14,75
SONOMA COUNTY,ROHNERT PARK DPS,57,0,15,72
SONOMA COUNTY,SANTA ROSA PD,167,0,25,192
SONOMA COUNTY,SEBASTOPOL PD,14,9,6,29
SONOMA COUNTY,SONOMA CO DA,14,0,0,14
SONOMA COUNTY,"SONOMA CO HUM SRV,WLF FRD INV",5,0,0,5
SONOMA COUNTY,SONOMA CO JR COLLEGE DIST PD,12,0,5,17
SONOMA COUNTY,SONOMA CO SHERIFF'S OFFICE,231,4,30,265
STANISLAUS COUNTY,CERES DPS,44,4,13,61
STANISLAUS COUNTY,CSU STANISLAUS DPS,12,0,1,13
STANISLAUS COUNTY,MODESTO PD,200,20,0,220
STANISLAUS COUNTY,NEWMAN PD,12,3,0,15
STANISLAUS COUNTY,OAKDALE PD,19,8,8,35
STANISLAUS COUNTY,STANISLAUS CO DA,15,0,0,15
STANISLAUS COUNTY,STANISLAUS CO SD,193,30,1,224
STANISLAUS COUNTY,STANISLAUS REGIONAL 9-1-1,1,0,54,55
STANISLAUS COUNTY,TURLOCK PD,73,0,15,88
SUTTER COUNTY,SUTTER CO DA,5,0,0,5
SUTTER COUNTY,SUTTER CO SD,105,25,12,142
SUTTER COUNTY,YUBA CITY PD,56,9,12,77
SUTTER COUNTY,CORNING PD,13,0,6,19
SUTTER COUNTY,RED BLUFF PD,22,1,6,29
SUTTER COUNTY,TEHAMA CO DA,7,0,0,7
SUTTER COUNTY,TEHAMA CO SD,85,6,9,100
TRINITY COUNTY,TRINITY CO DIST ATTORNEY,1,0,0,1
TRINITY COUNTY,TRINITY CO MARSHAL,2,0,0,2
TRINITY COUNTY,TRINITY COUNTY SD,18,10,2,30
TULARE COUNTY,COLLEGE OF THE SEQUOIAS PD,5,2,0,7
TULARE COUNTY,DINUBA PD,33,4,6,43
TULARE COUNTY,EXETER PD,17,8,1,26
TULARE COUNTY,FARMERSVILLE PD,13,3,1,17
TULARE COUNTY,LINDSAY DPS,18,1,2,21
TULARE COUNTY,PORTERVILLE PD,55,4,15,74
TULARE COUNTY,TULARE CO DA,36,0,0,36
TULARE COUNTY,TULARE CO SD,525,30,19,574
TULARE COUNTY,TULARE PD,73,0,12,85
TULARE COUNTY,VISALIA PD,137,4,27,168
TULARE COUNTY,WOODLAKE PD,9,3,0,12
TUOLUMNE COUNTY,SONORA PD,12,0,7,19
TUOLUMNE COUNTY,TUOLUMNE CO DA,1,0,0,1
TUOLUMNE COUNTY,TUOLUMNE CO SD,59,10,13,82
VENTURA COUNTY,CSU CHANNEL ISLANDS PD,14,0,5,19
VENTURA COUNTY,OXNARD PD,234,13,23,270
VENTURA COUNTY,PORT HUENEME PD,20,7,5,32
VENTURA COUNTY,SANTA PAULA PD,30,18,5,53
VENTURA COUNTY,SIMI VALLEY PD,123,3,17,143
VENTURA COUNTY,VENTURA CO CCD PD,16,0,0,16
VENTURA COUNTY,VENTURA CO DA,48,0,0,48
VENTURA COUNTY,VENTURA CO SD,728,18,32,778
VENTURA COUNTY,VENTURA PD,122,0,13,135
YOLO COUNTY,DAVIS PD,58,5,15,78
YOLO COUNTY,UC DAVIS PD,45,0,9,54
YOLO COUNTY,WEST SACRAMENTO PD,65,5,0,70
YOLO COUNTY,WINTERS PD,11,1,1,13
YOLO COUNTY,WOODLAND PD,60,0,0,60
YOLO COUNTY,YOLO CO COMM EMER,0,0,34,34
YOLO COUNTY,YOLO CO DA,14,0,0,14
YOLO COUNTY,YOLO CO SD,89,6,0,95
YUBA COUNTY,MARYSVILLE PD,16,17,9,42
YUBA COUNTY,WHEATLAND PD,5,4,0,9
YUBA COUNTY,YUBA CO SD,68,26,11,105
YUBA COUNTY,YUBA COMMUNITY COLL DIST PD,5,0,0,5
YUBA COUNTY,** GRAND TOTAL,80467,5078,7880,93425
