County,Agency,Sworn,Reserve,Dispatcher,Total
ALAMEDA COUNTY,ALAMEDA CO SD/CORONER,1104,50,47,1201
ALAMEDA COUNTY,ALAMEDA PD,87,0,15,102
ALAMEDA COUNTY,ALAMEDA/CONTRA COSTA TRANSIT,1,0,0,1
ALAMEDA COUNTY,ALBANY PD,25,4,8,37
ALAMEDA COUNTY,BAY AREA RAPID TRANSIT PD,188,0,17,205
ALAMEDA COUNTY,BERKELEY PD,176,20,32,228
ALAMEDA COUNTY,CSU EAST BAY PD,15,0,5,20
ALAMEDA COUNTY,EAST BAY REG PARK DPS,55,2,15,72
ALAMEDA COUNTY,EMERYVILLE PD,37,0,15,52
ALAMEDA COUNTY,FREMONT PD,180,8,26,214
ALAMEDA COUNTY,HAYWARD PD,194,27,28,249
ALAMEDA COUNTY,LIVERMORE PD,87,5,20,112
ALAMEDA COUNTY,MORAGA PD,10,4,0,14
ALAMEDA COUNTY,NEWARK PD,54,3,12,69
ALAMEDA COUNTY,OAKLAND CITY HOUSING AUTH PD,22,5,0,27
ALAMEDA COUNTY,OAKLAND PD,777,12,69,858
ALAMEDA COUNTY,OAKLAND USD PD,13,0,0,13
ALAMEDA COUNTY,OHLONE CCD PD,3,0,0,3
ALAMEDA COUNTY,PIEDMONT PD,19,4,6,29
ALAMEDA COUNTY,PLEASANTON PD,83,1,17,101
ALAMEDA COUNTY,SAN LEANDRO PD,93,0,18,111
ALAMEDA COUNTY,UC BERKELEY PD,63,0,8,71
ALAMEDA COUNTY,UNION CITY PD,74,2,15,91
ALPINE COUNTY,ALPINE CO SD,14,1,0,15
AMADOR COUNTY,AMADOR CO DA,8,0,0,8
AMADOR COUNTY,AMADOR CO SD/CORONER,49,5,12,66
AMADOR COUNTY,IONE PD,6,3,0,9
AMADOR COUNTY,JACKSON PD,9,10,1,20
AMADOR COUNTY,SUTTER CREEK PD,5,3,0,8
BUTTE COUNTY,BUTTE CCD PD,3,0,0,3
BUTTE COUNTY,BUTTE CO DA,21,0,0,21
BUTTE COUNTY,BUTTE CO SD/CORONER,95,36,14,145
BUTTE COUNTY,CHICO PD,97,2,21,120
BUTTE COUNTY,CSU CHICO PD,16,0,7,23
BUTTE COUNTY,GRIDLEY PD,13,9,8,30
BUTTE COUNTY,OROVILLE PD,24,1,9,34
BUTTE COUNTY,PARADISE PD,24,0,11,35
CALAVERAS COUNTY,ANGELS CAMP PD,8,2,3,13
CALAVERAS COUNTY,CALAVERAS CO DA,2,0,0,2
CALAVERAS COUNTY,CALAVERAS CO SD,56,12,12,80
COLUSA COUNTY,COLUSA CO DISTRICT ATTORNEY,2,0,0,2
COLUSA COUNTY,COLUSA COUNTY SD,33,1,10,44
COLUSA COUNTY,COLUSA PD,9,0,0,9
COLUSA COUNTY,WILLIAMS PD,9,0,0,9
CONTRA COSTA COUNTY,ANTIOCH PD,106,4,20,130
CONTRA COSTA COUNTY,BRENTWOOD PD,60,0,0,60
CONTRA COSTA COUNTY,CLAYTON PD,11,2,0,13
CONTRA COSTA COUNTY,CONCORD PD,149,15,17,181
CONTRA COSTA COUNTY,CONTRA COSTA CCD PD,24,0,0,24
CONTRA COSTA COUNTY,CONTRA COSTA CO DA,17,0,0,17
CONTRA COSTA COUNTY,CONTRA COSTA CO SD/CORONER,627,57,46,730
CONTRA COSTA COUNTY,EL CERRITO PD,42,5,0,47
CONTRA COSTA COUNTY,HERCULES PD,30,4,0,34
CONTRA COSTA COUNTY,KENSINGTON PD,10,5,0,15
CONTRA COSTA COUNTY,MARTINEZ PD,39,6,11,56
CONTRA COSTA COUNTY,PINOLE PD,30,3,9,42
CONTRA COSTA COUNTY,PITTSBURG PD,76,6,0,82
CONTRA COSTA COUNTY,PLEASANT HILL PD,43,5,9,57
CONTRA COSTA COUNTY,RICHMOND PD,181,1,26,208
CONTRA COSTA COUNTY,SAN PABLO PD,53,1,0,54
CONTRA COSTA COUNTY,SAN RAMON PD,58,0,0,58
CONTRA COSTA COUNTY,WALNUT CREEK PD,77,36,16,129
DEL NORTE COUNTY,CRESCENT CITY PD,14,4,1,19
DEL NORTE COUNTY,DEL NORTE CO DA,2,0,0,2
DEL NORTE COUNTY,DEL NORTE COUNTY SD,28,13,3,44
EL DORADO COUNTY,EL DORADO CO DA,14,0,0,14
EL DORADO COUNTY,EL DORADO CO SD,179,9,31,219
EL DORADO COUNTY,PLACERVILLE PD,18,2,6,26
EL DORADO COUNTY,SOUTH LAKE TAHOE PD,39,10,9,58
FRESNO COUNTY,CLOVIS PD,97,20,23,140
FRESNO COUNTY,CLOVIS UNIF SCHL DIST PD,10,0,0,10
FRESNO COUNTY,COALINGA PD,22,8,6,36
FRESNO COUNTY,CSU FRESNO DPS,19,0,5,24
FRESNO COUNTY,FIREBAUGH PD,12,4,0,16
FRESNO COUNTY,FOWLER PD,10,5,0,15
FRESNO COUNTY,FRESNO CO DA,49,0,0,49
FRESNO COUNTY,FRESNO CO SD,424,37,37,498
FRESNO COUNTY,FRESNO PD,808,54,87,949
FRESNO COUNTY,FRESNO YOSEMITE INT'L AIRPORT,4,0,0,4
FRESNO COUNTY,HURON PD,10,6,1,17
FRESNO COUNTY,KERMAN PD,16,3,0,19
FRESNO COUNTY,KINGSBURG PD,14,8,6,28
FRESNO COUNTY,MENDOTA PD,8,7,0,15
FRESNO COUNTY,ORANGE COVE PD,12,2,0,14
FRESNO COUNTY,PARLIER PD,17,1,0,18
FRESNO COUNTY,REEDLEY PD,32,0,6,38
FRESNO COUNTY,SANGER PD,34,4,3,41
FRESNO COUNTY,SELMA PD,32,4,6,42
FRESNO COUNTY,STATE CENTER CCD PD,15,0,0,15
GLENN COUNTY,GLENN CO DA,2,0,0,2
GLENN COUNTY,GLENN CO SD/CORONER,27,4,10,41
GLENN COUNTY,ORLAND PD,10,0,0,10
GLENN COUNTY,WILLOWS PD,10,1,0,11
HUMBOLDT COUNTY,ARCATA PD,27,3,6,36
HUMBOLDT COUNTY,CSU HUMBOLDT DPS,13,0,7,20
HUMBOLDT COUNTY,EUREKA PD,46,5,13,64
HUMBOLDT COUNTY,FERNDALE PD,5,0,0,5
HUMBOLDT COUNTY,FORTUNA PD,18,1,7,26
HUMBOLDT COUNTY,HUMBOLDT CO CORONER,4,0,0,4
HUMBOLDT COUNTY,HUMBOLDT CO DA,9,1,0,10
HUMBOLDT COUNTY,HUMBOLDT CO SD,184,26,15,225
HUMBOLDT COUNTY,HUMBOLDT DEPT WELFARE/INVEST,7,0,0,7
HUMBOLDT COUNTY,RIO DELL PD,7,1,0,8
HUMBOLDT COUNTY,TRINIDAD PD,2,1,0,3
IMPERIAL COUNTY,BRAWLEY PD,36,1,7,44
IMPERIAL COUNTY,CALEXICO PD,41,6,9,56
IMPERIAL COUNTY,CALIPATRIA PD,5,4,0,9
IMPERIAL COUNTY,EL CENTRO PD,53,1,10,64
IMPERIAL COUNTY,HOLTVILLE PD,0,0,0,0
IMPERIAL COUNTY,IMPERIAL CO DA,12,0,0,12
IMPERIAL COUNTY,IMPERIAL CO SD,105,9,13,127
IMPERIAL COUNTY,IMPERIAL PD,16,3,0,19
IMPERIAL COUNTY,WESTMORLAND PD,5,2,0,7
INYO COUNTY,BISHOP PD,12,2,6,20
INYO COUNTY,INYO CO DA,3,0,0,3
INYO COUNTY,INYO COUNTY SD,36,11,6,53
KERN COUNTY,ARVIN PD,17,3,6,26
KERN COUNTY,BAKERSFIELD PD,351,20,34,405
KERN COUNTY,BEAR VALLEY PD,8,1,13,22
KERN COUNTY,CALIFORNIA CITY PD,17,8,5,30
KERN COUNTY,CSU BAKERSFIELD DPS,11,0,4,15
KERN COUNTY,DELANO PD,46,5,6,57
KERN COUNTY,KERN CO DA,21,0,0,21
KERN COUNTY,KERN CO-DEPT OF PARKS & REC,10,0,0,10
KERN COUNTY,KERN COUNTY SD,845,91,37,973
KERN COUNTY,KERN HIGH SCHOOL DISTRICT PD,22,0,0,22
KERN COUNTY,MARICOPA PD,8,10,0,18
KERN COUNTY,MCFARLAND PD,10,2,0,12
KERN COUNTY,RIDGECREST PD,34,9,5,48
KERN COUNTY,SHAFTER PD,20,5,6,31
KERN COUNTY,STALLION SPRINGS PD,3,0,0,3
KERN COUNTY,TAFT PD,16,3,5,24
KERN COUNTY,TEHACHAPI PD,13,1,0,14
KINGS COUNTY,CORCORAN PD,21,2,6,29
KINGS COUNTY,HANFORD PD,51,6,15,72
KINGS COUNTY,KINGS CO DA,12,0,0,12
KINGS COUNTY,KINGS CO SD,76,6,15,97
KINGS COUNTY,"KINGS CO-HUMAN SVCS,WELFARE FD",5,0,0,5
KINGS COUNTY,LEMOORE PD,29,4,0,33
LAKE COUNTY,CLEARLAKE PD,20,1,5,26
LAKE COUNTY,LAKE CO DA,8,0,0,8
LAKE COUNTY,LAKE CO SD,60,3,12,75
LAKE COUNTY,LAKEPORT PD,11,1,0,12
LASSEN COUNTY,LASSEN CO DA,1,0,0,1
LASSEN COUNTY,LASSEN CO SD,33,20,7,60
LASSEN COUNTY,SUSANVILLE PD,16,2,0,18
LOS ANGELES COUNTY,ALHAMBRA PD,84,11,13,108
LOS ANGELES COUNTY,ARCADIA PD,66,9,11,86
LOS ANGELES COUNTY,AZUSA PD,59,7,12,78
LOS ANGELES COUNTY,BALDWIN PARK PD,73,4,9,86
LOS ANGELES COUNTY,BELL GARDENS PD,51,0,5,56
LOS ANGELES COUNTY,BELL PD,40,7,6,53
LOS ANGELES COUNTY,BEVERLY HILLS PD,130,6,17,153
LOS ANGELES COUNTY,BURBANK AIRPORT AUTH PD,29,0,0,29
LOS ANGELES COUNTY,BURBANK PD,150,10,16,176
LOS ANGELES COUNTY,BURLINGTON NORTHRN SANTA FE RR,25,0,0,25
LOS ANGELES COUNTY,CA DEPT CORPORATIONS,3,0,0,3
LOS ANGELES COUNTY,CA DEPT INDUSTRIAL RELATIONS,6,0,0,6
LOS ANGELES COUNTY,CERRITOS CCD PD,10,0,0,10
LOS ANGELES COUNTY,CLAREMONT PD,36,4,7,47
LOS ANGELES COUNTY,COMPTON UNIF SCH DIST PD,32,0,0,32
LOS ANGELES COUNTY,COVINA PD,56,2,12,70
LOS ANGELES COUNTY,CSU DOMINGUEZ HILLS DPS,16,0,6,22
LOS ANGELES COUNTY,CSU LONG BEACH PD,28,0,9,37
LOS ANGELES COUNTY,CSU LOS ANGELES DPS,19,0,6,25
LOS ANGELES COUNTY,CSU NORTHRIDGE DPS,23,0,6,29
LOS ANGELES COUNTY,CSU POMONA DPS,18,0,6,24
LOS ANGELES COUNTY,CULVER CITY PD,102,26,0,128
LOS ANGELES COUNTY,DOWNEY PD,116,0,15,131
LOS ANGELES COUNTY,EL CAMINO CCD PD,26,0,4,30
LOS ANGELES COUNTY,EL MONTE PD,128,53,17,198
LOS ANGELES COUNTY,EL SEGUNDO PD,65,0,13,78
LOS ANGELES COUNTY,GARDENA PD,92,7,0,99
LOS ANGELES COUNTY,GLENDALE CCD PD,10,0,0,10
LOS ANGELES COUNTY,GLENDALE PD,254,13,31,298
LOS ANGELES COUNTY,GLENDALE PD PARK RANGERS,4,2,0,6
LOS ANGELES COUNTY,GLENDORA PD,52,9,14,75
LOS ANGELES COUNTY,HACIENDA LA PUENTE USD,6,0,0,6
LOS ANGELES COUNTY,HAWTHORNE PD,97,4,0,101
LOS ANGELES COUNTY,HERMOSA BEACH PD,34,4,0,38
LOS ANGELES COUNTY,HUNTINGTON PARK PD,68,12,11,91
LOS ANGELES COUNTY,INGLEWOOD PD,193,0,21,214
LOS ANGELES COUNTY,INGLEWOOD UNIF SCH DIST PD,9,5,0,14
LOS ANGELES COUNTY,IRWINDALE PD,26,4,7,37
LOS ANGELES COUNTY,LA VERNE PD,43,21,10,74
LOS ANGELES COUNTY,LONG BEACH PD,904,46,60,1010
LOS ANGELES COUNTY,LOS ANGELES CITY DPT GEN SVCS,96,0,9,105
LOS ANGELES COUNTY,LOS ANGELES CITY HOUSING AUTH,1,0,0,1
LOS ANGELES COUNTY,LOS ANGELES CITY PARK RANGER,13,0,0,13
LOS ANGELES COUNTY,LOS ANGELES CO CORONER,48,0,0,48
LOS ANGELES COUNTY,LOS ANGELES CO DA,284,0,2,286
LOS ANGELES COUNTY,LOS ANGELES CO OFC PUBLIC SFTY,377,2,30,409
LOS ANGELES COUNTY,LOS ANGELES CO SD,9654,877,508,11039
LOS ANGELES COUNTY,LOS ANGELES PD,9841,456,589,10886
LOS ANGELES COUNTY,LOS ANGELES PORT PD,129,2,6,137
LOS ANGELES COUNTY,LOS ANGELES SCHOOL PD,325,0,0,325
LOS ANGELES COUNTY,LOS ANGELES WORLD AIRPORTS PD,506,0,0,506
LOS ANGELES COUNTY,MANHATTAN BEACH PD,62,5,0,67
LOS ANGELES COUNTY,MAYWOOD PD,39,3,4,46
LOS ANGELES COUNTY,MONROVIA PD,51,6,8,65
LOS ANGELES COUNTY,MONTEBELLO PD,76,15,12,103
LOS ANGELES COUNTY,MONTEBELLO UNIFIED SCHOOL DIST,6,1,0,7
LOS ANGELES COUNTY,MONTEREY PARK PD,72,31,11,114
LOS ANGELES COUNTY,PALOS VERDES ESTATES PD,22,24,10,56
LOS ANGELES COUNTY,PASADENA CITY CCD PD,9,0,5,14
LOS ANGELES COUNTY,PASADENA PD,243,25,33,301
LOS ANGELES COUNTY,POMONA PD,167,5,29,201
LOS ANGELES COUNTY,REDONDO BEACH PD,97,15,19,131
LOS ANGELES COUNTY,SAN FERNANDO PD,36,22,7,65
LOS ANGELES COUNTY,SAN GABRIEL PD,55,5,4,64
LOS ANGELES COUNTY,SAN MARINO PD,28,0,6,34
LOS ANGELES COUNTY,SANTA MONICA CCD PD,16,0,5,21
LOS ANGELES COUNTY,SANTA MONICA PD,208,0,12,220
LOS ANGELES COUNTY,SIERRA MADRE PD,15,7,3,25
LOS ANGELES COUNTY,SIGNAL HILL PD,36,2,8,46
LOS ANGELES COUNTY,SOUTH BAY REG PUB COMM AUTH,0,0,45,45
LOS ANGELES COUNTY,SOUTH GATE PD,83,1,8,92
LOS ANGELES COUNTY,SOUTH PASADENA PD,35,12,7,54
LOS ANGELES COUNTY,TORRANCE PD,211,2,21,234
LOS ANGELES COUNTY,UC LOS ANGELES PD,59,0,14,73
LOS ANGELES COUNTY,UNION PACIFIC RAILROAD,59,0,0,59
LOS ANGELES COUNTY,VERNON PD,52,0,8,60
LOS ANGELES COUNTY,WEST COVINA PD,109,15,15,139
LOS ANGELES COUNTY,WHITTIER PD,124,4,14,142
MADERA COUNTY,CHOWCHILLA PD,16,2,7,25
MADERA COUNTY,MADERA CO DA,8,0,0,8
MADERA COUNTY,MADERA CO SD,68,50,10,128
MADERA COUNTY,MADERA PD,58,0,8,66
MARIN COUNTY,BELVEDERE PD,10,0,0,10
MARIN COUNTY,FAIRFAX PD,11,1,5,17
MARIN COUNTY,MARIN CCD PD,7,0,0,7
MARIN COUNTY,MARIN CO CORONER,4,0,0,4
MARIN COUNTY,MARIN CO DA,6,0,0,6
MARIN COUNTY,MARIN CO SD,200,0,50,250
MARIN COUNTY,MILL VALLEY PD,21,2,0,23
MARIN COUNTY,NOVATO PD,59,0,11,70
MARIN COUNTY,ROSS PD,8,1,0,9
MARIN COUNTY,SAN ANSELMO PD,19,5,3,27
MARIN COUNTY,SAN RAFAEL PD,65,8,17,90
MARIN COUNTY,SAUSALITO PD,18,0,0,18
MARIN COUNTY,TIBURON PD,13,5,0,18
MARIN COUNTY,TWIN CITIES PD,32,1,11,44
MARIPOSA COUNTY,MARIPOSA CO DA,1,0,0,1
MARIPOSA COUNTY,MARIPOSA CO SD,41,10,0,51
MENDOCINO COUNTY,FORT BRAGG PD,16,0,0,16
MENDOCINO COUNTY,MENDOCINO CO DA,6,0,0,6
MENDOCINO COUNTY,MENDOCINO CO SD,121,8,13,142
MENDOCINO COUNTY,UKIAH PD,27,3,10,40
MENDOCINO COUNTY,WILLITS PD,13,0,10,23
MERCED COUNTY,ATWATER PD,32,5,9,46
MERCED COUNTY,DOS PALOS PD,7,4,0,11
MERCED COUNTY,GUSTINE PD,7,3,1,11
MERCED COUNTY,LIVINGSTON PD,20,2,7,29
MERCED COUNTY,LOS BANOS PD,37,0,10,47
MERCED COUNTY,MERCED CCD PD,3,0,0,3
MERCED COUNTY,MERCED CO DA,13,0,0,13
MERCED COUNTY,MERCED CO SD,110,40,10,160
MERCED COUNTY,MERCED PD,98,17,15,130
MERCED COUNTY,UC MERCED PD,10,0,5,15
MODOC COUNTY,ALTURAS PD,6,2,0,8
MODOC COUNTY,MODOC CO DA,1,0,0,1
MODOC COUNTY,MODOC CO SD,15,0,4,19
MONO COUNTY,MAMMOTH LAKES PD,21,0,0,21
MONO COUNTY,MONO CO DA,2,0,0,2
MONO COUNTY,MONO CO SD,28,2,17,47
MONTEREY COUNTY,CARMEL PD,13,3,5,21
MONTEREY COUNTY,CSU MONTEREY BAY PD,14,0,0,14
MONTEREY COUNTY,DEL REY OAKS PD,6,15,0,21
MONTEREY COUNTY,GONZALES PD,14,1,0,15
MONTEREY COUNTY,GREENFIELD PD,15,1,0,16
MONTEREY COUNTY,KING CITY PD,16,4,0,20
MONTEREY COUNTY,MARINA PD,35,2,0,37
MONTEREY COUNTY,MONTEREY CO DA,24,0,0,24
MONTEREY COUNTY,MONTEREY CO EMER COMM,1,0,54,55
MONTEREY COUNTY,MONTEREY CO SHERIFF'S OFFICE,309,6,0,315
MONTEREY COUNTY,MONTEREY PD,50,0,0,50
MONTEREY COUNTY,MONTEREY PENN AIRPORT DIST PD,7,0,0,7
MONTEREY COUNTY,PACIFIC GROVE PD,20,4,0,24
MONTEREY COUNTY,SALINAS PD,166,9,0,175
MONTEREY COUNTY,SAND CITY PD,10,3,0,13
MONTEREY COUNTY,SEASIDE PD,42,6,0,48
MONTEREY COUNTY,SOLEDAD PD,20,0,0,20
NAPA COUNTY,CALISTOGA PD,11,1,5,17
NAPA COUNTY,NAPA CO DA,8,0,0,8
NAPA COUNTY,NAPA CO SD,98,0,0,98
NAPA COUNTY,NAPA PD,72,0,24,96
NAPA COUNTY,NAPA VALLEY COLLEGE DPS,4,0,0,4
NAPA COUNTY,NAPA VALLEY RR PD,1,0,0,1
NAPA COUNTY,SAINT HELENA PD,12,1,5,18
NEVADA COUNTY,GRASS VALLEY PD,23,5,4,32
NEVADA COUNTY,NEVADA CITY PD,12,3,0,15
NEVADA COUNTY,NEVADA CO DA,4,0,0,4
NEVADA COUNTY,NEVADA CO SD,69,18,19,106
NEVADA COUNTY,TRUCKEE PD,21,4,0,25
ORANGE COUNTY,ANAHEIM PD,391,19,39,449
ORANGE COUNTY,BREA PD,98,1,17,116
ORANGE COUNTY,BUENA PARK PD,91,8,9,108
ORANGE COUNTY,COSTA MESA COMM DEPT,0,0,24,24
ORANGE COUNTY,COSTA MESA PD,151,6,0,157
ORANGE COUNTY,CSU FULLERTON PD,21,0,7,28
ORANGE COUNTY,CYPRESS PD,56,2,0,58
ORANGE COUNTY,FOUNTAIN VALLEY PD,57,3,8,68
ORANGE COUNTY,FULLERTON PD,151,16,20,187
ORANGE COUNTY,GARDEN GROVE PD,160,28,19,207
ORANGE COUNTY,HUNTINGTON BEACH PD,217,8,27,252
ORANGE COUNTY,IRVINE PD,199,3,20,222
ORANGE COUNTY,IRVINE VALLEY CCD PD,3,0,0,3
ORANGE COUNTY,LA HABRA PD,64,9,11,84
ORANGE COUNTY,LA PALMA PD,24,5,7,36
ORANGE COUNTY,LAGUNA BEACH PD,46,6,11,63
ORANGE COUNTY,LOS ALAMITOS PD,22,5,0,27
ORANGE COUNTY,NEWPORT BEACH PD,137,15,19,171
ORANGE COUNTY,ORANGE CO DA,134,0,0,134
ORANGE COUNTY,ORANGE CO DA WELFARE/FRAUD INV,40,0,0,40
ORANGE COUNTY,ORANGE CO SD/CORONER,1815,255,57,2127
ORANGE COUNTY,ORANGE PD,163,15,18,196
ORANGE COUNTY,PLACENTIA PD,47,1,13,61
ORANGE COUNTY,SADDLEBACK CCD PD,8,0,0,8
ORANGE COUNTY,SANTA ANA PD,353,12,32,397
ORANGE COUNTY,SANTA ANA UNIF SCHL DIST PD,17,3,0,20
ORANGE COUNTY,SEAL BEACH PD,31,5,0,36
ORANGE COUNTY,TUSTIN PD,93,7,13,113
ORANGE COUNTY,UC IRVINE PD,29,0,9,38
ORANGE COUNTY,WEST CITIES COMM CTR,0,0,25,25
ORANGE COUNTY,WESTMINSTER PD,96,13,17,126
PLACER COUNTY,AUBURN PD,22,5,8,35
PLACER COUNTY,LINCOLN PD,31,1,7,39
PLACER COUNTY,PLACER CO DA,10,0,0,10
PLACER COUNTY,PLACER COUNTY SD,235,68,30,333
PLACER COUNTY,ROCKLIN PD,51,5,14,70
PLACER COUNTY,ROSEVILLE PD,119,4,25,148
PLACER COUNTY,SIERRA COLLEGE PD (OBS),3,0,0,3
PLUMAS COUNTY,PLUMAS CO SD,31,12,9,52
RIVERSIDE COUNTY,BANNING PD,35,2,9,46
RIVERSIDE COUNTY,BEAUMONT PD,57,0,14,71
RIVERSIDE COUNTY,BLYTHE PD,22,3,9,34
RIVERSIDE COUNTY,CATHEDRAL CITY PD,55,22,18,95
RIVERSIDE COUNTY,CORONA PD,175,3,27,205
RIVERSIDE COUNTY,DESERT HOT SPRINGS PD,27,3,1,31
RIVERSIDE COUNTY,HEMET PD,67,0,16,83
RIVERSIDE COUNTY,INDIO PD,70,15,16,101
RIVERSIDE COUNTY,LAKE HEMET MUNCPL WATER DIST,0,0,0,0
RIVERSIDE COUNTY,MOUNT SAN JACINTO CCD PD,2,0,0,2
RIVERSIDE COUNTY,MURRIETA PD,90,3,20,113
RIVERSIDE COUNTY,PALM SPRINGS PD,94,16,17,127
RIVERSIDE COUNTY,RIVERSIDE CCD PD,17,9,0,26
RIVERSIDE COUNTY,RIVERSIDE CO DA,125,0,2,127
RIVERSIDE COUNTY,RIVERSIDE CO PUBLIC SOCIAL SER,25,0,0,25
RIVERSIDE COUNTY,RIVERSIDE CO SD,2067,52,176,2295
RIVERSIDE COUNTY,RIVERSIDE PD,363,0,50,413
RIVERSIDE COUNTY,UC RIVERSIDE PD,28,0,8,36
SACRAMENTO COUNTY,CA ALCOHOLIC BEVERAGE CONTROL,179,0,0,179
SACRAMENTO COUNTY,CA ASSEMBLY SGT AT ARMS LEGIS,18,0,0,18
SACRAMENTO COUNTY,CA DEPT CONSUMER AFF DEN BD,10,0,0,10
SACRAMENTO COUNTY,CA DEPT CONSUMER AFF INVEST,55,0,0,55
SACRAMENTO COUNTY,CA DEPT CONSUMER AFF MED BD,97,0,0,97
SACRAMENTO COUNTY,CA DEPT DEVELOPMENTAL OPS,100,0,0,100
SACRAMENTO COUNTY,CA DEPT EMPLOYMENT DEVELOPMENT,36,0,0,36
SACRAMENTO COUNTY,CA DEPT FISH & GAME,298,2,0,300
SACRAMENTO COUNTY,CA DEPT HEALTH CARE SVCS,119,0,0,119
SACRAMENTO COUNTY,CA DEPT INSURANCE FRAUD,193,0,0,193
SACRAMENTO COUNTY,CA DEPT JUSTICE,454,0,0,454
SACRAMENTO COUNTY,CA DEPT MENTAL HEALTH,21,0,0,21
SACRAMENTO COUNTY,CA DEPT MOTOR VEHICLES,229,0,0,229
SACRAMENTO COUNTY,CA DEPT PARKS & RECREATION,611,0,69,680
SACRAMENTO COUNTY,CA DEPT PUB HEALTH FOOD/DRUG,109,0,0,109
SACRAMENTO COUNTY,CA DEPT SOCIAL SERVICES,50,0,0,50
SACRAMENTO COUNTY,CA DEPT TOXIC SUBSTANCES CNTL,13,0,0,13
SACRAMENTO COUNTY,CA FRANCHISE TAX BOARD,41,0,0,41
SACRAMENTO COUNTY,CA HIGHWAY PATROL,7682,0,1,7683
SACRAMENTO COUNTY,CA HORSE RACING BOARD,13,0,0,13
SACRAMENTO COUNTY,CA SECRETARY OF STATE OFC INV,7,0,0,7
SACRAMENTO COUNTY,CA STATE CONTROLLER,3,0,0,3
SACRAMENTO COUNTY,CA STATE FAIR PD,3,0,0,3
SACRAMENTO COUNTY,CA STATE LOTTERY,29,0,0,29
SACRAMENTO COUNTY,CAL - EMA,9,0,0,9
SACRAMENTO COUNTY,CAL FIRE,230,0,0,230
SACRAMENTO COUNTY,CITRUS HEIGHTS PD,86,14,23,123
SACRAMENTO COUNTY,CSU SACRAMENTO DPS,23,0,6,29
SACRAMENTO COUNTY,ELK GROVE PD,124,12,22,158
SACRAMENTO COUNTY,FOLSOM PD,82,7,16,105
SACRAMENTO COUNTY,GALT PD,36,1,7,44
SACRAMENTO COUNTY,ISLETON PD,2,9,0,11
SACRAMENTO COUNTY,LOS RIOS CCD PD,30,2,0,32
SACRAMENTO COUNTY,SACRAMENTO CO CORONER,16,0,0,16
SACRAMENTO COUNTY,SACRAMENTO CO DA,42,0,0,42
SACRAMENTO COUNTY,SACRAMENTO CO HUMAN ASST INV,23,0,0,23
SACRAMENTO COUNTY,SACRAMENTO CO REG PARKS DEPT,18,0,0,18
SACRAMENTO COUNTY,SACRAMENTO CO SD,1219,653,61,1933
SACRAMENTO COUNTY,SACRAMENTO PD,713,69,87,869
SACRAMENTO COUNTY,TWIN RIVERS USD PD,22,12,0,34
SAN BENITO COUNTY,HOLLISTER PD,27,0,0,27
SAN BENITO COUNTY,SAN BENITO CO DA,2,0,0,2
SAN BENITO COUNTY,SAN BENITO CO MARSHAL,1,6,0,7
SAN BENITO COUNTY,SAN BENITO CO OES,0,0,14,14
SAN BENITO COUNTY,SAN BENITO CO SD,32,6,0,38
SAN BERNARDINO COUNTY,BARSTOW PD,38,3,7,48
SAN BERNARDINO COUNTY,CHINO PD,96,1,22,119
SAN BERNARDINO COUNTY,COLTON PD,62,4,13,79
SAN BERNARDINO COUNTY,CSU SAN BERNARDINO DPS,16,0,9,25
SAN BERNARDINO COUNTY,FONTANA PD,184,3,25,212
SAN BERNARDINO COUNTY,FONTANA UNIFIED SCHOOL DIST,17,0,10,27
SAN BERNARDINO COUNTY,HESPERIA UNIFIED SCHOOL DIST,8,0,0,8
SAN BERNARDINO COUNTY,MONTCLAIR PD,50,6,9,65
SAN BERNARDINO COUNTY,ONTARIO PD,221,9,38,268
SAN BERNARDINO COUNTY,REDLANDS PD,79,10,16,105
SAN BERNARDINO COUNTY,RIALTO PD,109,2,13,124
SAN BERNARDINO COUNTY,SAN BERNARDINO CCD PD,8,0,0,8
SAN BERNARDINO COUNTY,SAN BERNARDINO CO DA,54,0,0,54
SAN BERNARDINO COUNTY,SAN BERNARDINO CO SD,1847,240,152,2239
SAN BERNARDINO COUNTY,SAN BERNARDINO PD,322,28,43,393
SAN BERNARDINO COUNTY,SAN BERNARDINO UNIF SCHL DIST,25,3,7,35
SAN BERNARDINO COUNTY,SNOWLINE JOINT UNIF SCHL DIST,4,1,0,5
SAN BERNARDINO COUNTY,UPLAND PD,72,8,18,98
SAN DIEGO COUNTY,CARLSBAD PD,113,7,19,139
SAN DIEGO COUNTY,CHULA VISTA PD,231,10,24,265
SAN DIEGO COUNTY,CORONADO PD,42,1,7,50
SAN DIEGO COUNTY,CSU SAN DIEGO DPS,28,0,10,38
SAN DIEGO COUNTY,CSU SAN MARCOS DPS,15,0,6,21
SAN DIEGO COUNTY,EL CAJON PD,113,21,19,153
SAN DIEGO COUNTY,ESCONDIDO PD,158,14,23,195
SAN DIEGO COUNTY,GROSSMONT-CUYAMACA CCD PD,11,0,0,11
SAN DIEGO COUNTY,LA MESA PD,65,2,18,85
SAN DIEGO COUNTY,MIRA COSTA CCD PD,10,0,3,13
SAN DIEGO COUNTY,NATIONAL CITY PD,91,13,11,115
SAN DIEGO COUNTY,OCEANSIDE PD,212,7,28,247
SAN DIEGO COUNTY,PALOMAR CCD PD,10,0,0,10
SAN DIEGO COUNTY,SAN DIEGO CCD PD,38,0,8,46
SAN DIEGO COUNTY,SAN DIEGO CITY SCHOOLS PD,43,0,9,52
SAN DIEGO COUNTY,SAN DIEGO CO DA,178,0,0,178
SAN DIEGO COUNTY,SAN DIEGO CO SD,1225,117,125,1467
SAN DIEGO COUNTY,"SAN DIEGO HARBOR PD, PORT OF",136,0,14,150
SAN DIEGO COUNTY,SAN DIEGO PD,1897,32,154,2083
SAN DIEGO COUNTY,SOUTHWESTERN CCD PD,10,0,0,10
SAN DIEGO COUNTY,UC SAN DIEGO PD,33,0,9,42
SAN FRANCISCO COUNTY,CSU SAN FRANCISCO DPS,25,0,4,29
SAN FRANCISCO COUNTY,SAN FRANCISCO CCD PD,27,0,0,27
SAN FRANCISCO COUNTY,SAN FRANCISCO CO DA,29,0,0,29
SAN FRANCISCO COUNTY,SAN FRANCISCO CO MED EXAM,13,0,0,13
SAN FRANCISCO COUNTY,SAN FRANCISCO CO SD,908,0,0,908
SAN FRANCISCO COUNTY,SAN FRANCISCO DEPT EMER MGT,1,0,195,196
SAN FRANCISCO COUNTY,SAN FRANCISCO MUNICIPAL RWY PD,3,0,0,3
SAN FRANCISCO COUNTY,SAN FRANCISCO PD,2315,33,0,2348
SAN FRANCISCO COUNTY,SUPREME COURT OF CALIFORNIA,1,0,0,1
SAN FRANCISCO COUNTY,UC SAN FRANCISCO PD,47,0,9,56
SAN JOAQUIN COUNTY,ESCALON PD,10,13,1,24
SAN JOAQUIN COUNTY,LODI PD,73,7,22,102
SAN JOAQUIN COUNTY,MANTECA PD,59,22,10,91
SAN JOAQUIN COUNTY,RIPON PD,24,3,7,34
SAN JOAQUIN COUNTY,SAN JOAQUIN CO DA,33,0,0,33
SAN JOAQUIN COUNTY,SAN JOAQUIN CO SD,314,13,35,362
SAN JOAQUIN COUNTY,SAN JOAQUIN DELTA COLLEGE PD,10,0,0,10
SAN JOAQUIN COUNTY,STOCKTON PD,366,26,46,438
SAN JOAQUIN COUNTY,STOCKTON UNIF SCHL DIST PD,18,2,6,26
SAN JOAQUIN COUNTY,TRACY PD,86,2,15,103
SAN LUIS OBISPO COUNTY,ARROYO GRANDE PD,25,2,8,35
SAN LUIS OBISPO COUNTY,ATASCADERO PD,26,1,8,35
SAN LUIS OBISPO COUNTY,CPSU SAN LUIS OBISPO PD,19,0,7,26
SAN LUIS OBISPO COUNTY,CUESTA CCD DPS,6,0,0,6
SAN LUIS OBISPO COUNTY,GROVER BEACH PD,18,2,9,29
SAN LUIS OBISPO COUNTY,MORRO BAY PD,16,1,7,24
SAN LUIS OBISPO COUNTY,PASO ROBLES PD,35,5,7,47
SAN LUIS OBISPO COUNTY,PISMO BEACH PD,23,2,7,32
SAN LUIS OBISPO COUNTY,SAN LUIS OBISPO CO DA,14,0,0,14
SAN LUIS OBISPO COUNTY,SAN LUIS OBISPO CO SD,149,12,16,177
SAN LUIS OBISPO COUNTY,SAN LUIS OBISPO PD,59,0,13,72
SAN MATEO COUNTY,ATHERTON PD,17,6,14,37
SAN MATEO COUNTY,BELMONT PD,31,2,7,40
SAN MATEO COUNTY,BRISBANE PD,14,0,0,14
SAN MATEO COUNTY,BROADMOOR PD,6,26,0,32
SAN MATEO COUNTY,BURLINGAME PD,36,5,15,56
SAN MATEO COUNTY,COLMA PD,17,0,4,21
SAN MATEO COUNTY,DALY CITY PD,109,2,14,125
SAN MATEO COUNTY,EAST PALO ALTO PD,35,0,0,35
SAN MATEO COUNTY,FOSTER CITY PD,37,5,13,55
SAN MATEO COUNTY,HALF MOON BAY PD,14,2,0,16
SAN MATEO COUNTY,HILLSBOROUGH PD,26,1,5,32
SAN MATEO COUNTY,MENLO PARK PD,48,4,19,71
SAN MATEO COUNTY,MILLBRAE PD,19,2,4,25
SAN MATEO COUNTY,PACIFICA PD,36,6,9,51
SAN MATEO COUNTY,REDWOOD CITY PD,90,8,12,110
SAN MATEO COUNTY,SAN BRUNO PD,43,7,6,56
SAN MATEO COUNTY,SAN CARLOS PD,27,9,0,36
SAN MATEO COUNTY,SAN MATEO CO CORONER,6,0,0,6
SAN MATEO COUNTY,SAN MATEO CO DA,12,0,0,12
SAN MATEO COUNTY,SAN MATEO CO PUB SFTY COMM CTR,0,0,34,34
SAN MATEO COUNTY,SAN MATEO CO SD,297,36,0,333
SAN MATEO COUNTY,SAN MATEO PD,106,9,17,132
SAN MATEO COUNTY,SOUTH SAN FRANCISCO PD,75,13,13,101
SANTA BARBARA COUNTY,ALLAN HANCOCK CCD PD,2,3,3,8
SANTA BARBARA COUNTY,GUADALUPE PD,10,5,2,17
SANTA BARBARA COUNTY,LOMPOC PD,51,2,10,63
SANTA BARBARA COUNTY,SANTA BARBARA CO DA,19,0,0,19
SANTA BARBARA COUNTY,SANTA BARBARA CO SD,273,36,31,340
SANTA BARBARA COUNTY,SANTA BARBARA PD,135,11,15,161
SANTA BARBARA COUNTY,SANTA MARIA PD,106,7,19,132
SANTA BARBARA COUNTY,UC SANTA BARBARA PD,31,0,7,38
SANTA CLARA COUNTY,CAMPBELL PD,40,13,13,66
SANTA CLARA COUNTY,CSU SAN JOSE PD,29,0,6,35
SANTA CLARA COUNTY,FOOTHILL-DEANZA CCD PD,11,0,0,11
SANTA CLARA COUNTY,GILROY PD,56,9,13,78
SANTA CLARA COUNTY,LOS ALTOS PD,29,4,9,42
SANTA CLARA COUNTY,LOS GATOS PD,41,7,7,55
SANTA CLARA COUNTY,MILPITAS PD,85,5,13,103
SANTA CLARA COUNTY,MORGAN HILL PD,37,3,9,49
SANTA CLARA COUNTY,MOUNTAIN VIEW EMERG COMM,0,1,18,19
SANTA CLARA COUNTY,MOUNTAIN VIEW PD,96,19,0,115
SANTA CLARA COUNTY,PALO ALTO PD,89,8,25,122
SANTA CLARA COUNTY,SAN JOSE PD,1372,151,168,1691
SANTA CLARA COUNTY,SAN JOSE UNIF SCHL DIST PD,1,0,0,1
SANTA CLARA COUNTY,SAN JOSE/EVERGREEN CCD PD,5,0,1,6
SANTA CLARA COUNTY,SANTA CLARA CO COMM DEPT,0,0,84,84
SANTA CLARA COUNTY,SANTA CLARA CO DA,71,0,0,71
SANTA CLARA COUNTY,SANTA CLARA CO DA-WELFARE FRD,5,0,0,5
SANTA CLARA COUNTY,SANTA CLARA CO SD,466,69,0,535
SANTA CLARA COUNTY,SANTA CLARA PD,146,26,20,192
SANTA CLARA COUNTY,SUNNYVALE DPS,214,0,22,236
SANTA CLARA COUNTY,WEST VALLEY CCD PD,7,3,0,10
SANTA CRUZ COUNTY,CAPITOLA PD,22,5,0,27
SANTA CRUZ COUNTY,SANTA CRUZ CO DA,14,0,0,14
SANTA CRUZ COUNTY,SANTA CRUZ CO SD,136,27,0,163
SANTA CRUZ COUNTY,SANTA CRUZ PD,86,1,0,87
SANTA CRUZ COUNTY,SCOTTS VALLEY PD,19,6,6,31
SANTA CRUZ COUNTY,UC SANTA CRUZ PD,19,0,8,27
SANTA CRUZ COUNTY,WATSONVILLE PD,64,0,0,64
SHASTA COUNTY,ANDERSON PD,18,0,5,23
SHASTA COUNTY,REDDING PD,109,0,0,109
SHASTA COUNTY,SHASTA AREA SAFETY COMM AGCY,0,0,40,40
SHASTA COUNTY,SHASTA CO DA,13,0,0,13
SHASTA COUNTY,SHASTA CO MARSHAL,22,0,0,22
SHASTA COUNTY,SHASTA CO SD,153,17,0,170
SIERRA COUNTY,SIERRA CO SD,9,3,0,12
SISKIYOU COUNTY,ETNA PD,2,0,0,2
SISKIYOU COUNTY,LAKE SHASTINA DISTRICT PD,4,0,0,4
SISKIYOU COUNTY,MOUNT SHASTA PD,8,4,2,14
SISKIYOU COUNTY,SISKIYOU CO DA,4,0,0,4
SISKIYOU COUNTY,SISKIYOU CO SD,89,5,10,104
SISKIYOU COUNTY,TULELAKE PD,4,0,0,4
SISKIYOU COUNTY,WEED PD,11,0,7,18
SISKIYOU COUNTY,YREKA PD,14,3,4,21
SOLANO COUNTY,BENICIA PD,36,0,15,51
SOLANO COUNTY,DIXON PD,25,0,0,25
SOLANO COUNTY,FAIRFIELD PD,118,0,19,137
SOLANO COUNTY,RIO VISTA PD,11,2,0,13
SOLANO COUNTY,SOLANO CCD PD,3,0,0,3
SOLANO COUNTY,SOLANO CO DA,11,0,0,11
SOLANO COUNTY,SOLANO CO SD,106,16,14,136
SOLANO COUNTY,SUISUN CITY PD,26,1,7,34
SOLANO COUNTY,VACAVILLE PD,106,4,18,128
SOLANO COUNTY,VALLEJO PD,96,10,22,128
SONOMA COUNTY,CLOVERDALE PD,13,3,8,24
SONOMA COUNTY,COTATI PD,10,2,6,18
SONOMA COUNTY,CSU SONOMA PD,10,0,5,15
SONOMA COUNTY,HEALDSBURG PD,16,1,6,23
SONOMA COUNTY,PETALUMA PD,67,0,16,83
SONOMA COUNTY,ROHNERT PARK DPS,65,1,16,82
SONOMA COUNTY,SANTA ROSA JUNIOR COLLEGE PD,11,0,7,18
SONOMA COUNTY,SANTA ROSA PD,171,0,20,191
SONOMA COUNTY,SEBASTOPOL PD,14,10,6,30
SONOMA COUNTY,SONOMA CO DA,17,0,0,17
SONOMA COUNTY,"SONOMA CO HUM SRV,WLF FRD INV",5,0,0,5
SONOMA COUNTY,SONOMA CO SHERIFF'S OFFICE,242,6,34,282
STANISLAUS COUNTY,CERES DPS,52,3,10,65
STANISLAUS COUNTY,CSU STANISLAUS DPS,11,0,5,16
STANISLAUS COUNTY,MODESTO PD,244,14,0,258
STANISLAUS COUNTY,NEWMAN PD,12,3,0,15
STANISLAUS COUNTY,OAKDALE PD,25,5,6,36
STANISLAUS COUNTY,STANISLAUS CO DA,16,0,0,16
STANISLAUS COUNTY,STANISLAUS CO SD,211,0,0,211
STANISLAUS COUNTY,STANISLAUS REGIONAL 9-1-1,0,0,52,52
STANISLAUS COUNTY,TURLOCK PD,81,0,17,98
SUTTER COUNTY,SUTTER CO DA,11,0,0,11
SUTTER COUNTY,SUTTER CO SD,107,32,14,153
SUTTER COUNTY,YUBA CITY PD,65,10,12,87
SUTTER COUNTY,CORNING PD,15,0,5,20
SUTTER COUNTY,RED BLUFF PD,21,3,6,30
SUTTER COUNTY,TEHAMA CO DA,7,0,0,7
SUTTER COUNTY,TEHAMA CO SD,80,8,7,95
TRINITY COUNTY,TRINITY CO DIST ATTORNEY,1,0,0,1
TRINITY COUNTY,TRINITY CO MARSHAL,3,0,0,3
TRINITY COUNTY,TRINITY COUNTY SD,16,6,0,22
TULARE COUNTY,COLLEGE OF THE SEQUOIAS PD,4,1,1,6
TULARE COUNTY,DINUBA PD,35,0,6,41
TULARE COUNTY,EXETER PD,17,8,0,25
TULARE COUNTY,FARMERSVILLE PD,16,4,1,21
TULARE COUNTY,LINDSAY DPS,18,3,2,23
TULARE COUNTY,PORTERVILLE PD,57,5,12,74
TULARE COUNTY,TULARE CO DA,32,0,0,32
TULARE COUNTY,TULARE CO SD,306,36,21,363
TULARE COUNTY,TULARE PD,72,1,12,85
TULARE COUNTY,VISALIA PD,131,9,22,162
TULARE COUNTY,WOODLAKE PD,14,2,2,18
TUOLUMNE COUNTY,SONORA PD,13,4,6,23
TUOLUMNE COUNTY,TUOLUMNE CO DA,4,0,0,4
TUOLUMNE COUNTY,TUOLUMNE CO SD,64,8,12,84
VENTURA COUNTY,CSU CHANNEL ISLANDS PD,13,0,6,19
VENTURA COUNTY,OXNARD PD,233,22,22,277
VENTURA COUNTY,PORT HUENEME PD,24,10,6,40
VENTURA COUNTY,SANTA PAULA PD,31,31,7,69
VENTURA COUNTY,SIMI VALLEY PD,115,4,18,137
VENTURA COUNTY,VENTURA CO CCD PD,16,0,0,16
VENTURA COUNTY,VENTURA CO DA,42,0,0,42
VENTURA COUNTY,VENTURA CO SD,706,25,35,766
VENTURA COUNTY,VENTURA PD,121,0,12,133
YOLO COUNTY,DAVIS PD,58,4,15,77
YOLO COUNTY,UC DAVIS PD,48,0,11,59
YOLO COUNTY,WEST SACRAMENTO PD,71,1,0,72
YOLO COUNTY,WINTERS PD,9,2,0,11
YOLO COUNTY,WOODLAND PD,64,0,0,64
YOLO COUNTY,YOLO CO COMM EMER,0,0,37,37
YOLO COUNTY,YOLO CO DA,13,0,0,13
YOLO COUNTY,YOLO CO SD,83,5,0,88
YUBA COUNTY,MARYSVILLE PD,19,17,6,42
YUBA COUNTY,WHEATLAND PD,8,0,0,8
YUBA COUNTY,YUBA CO SD,86,25,12,123
YUBA COUNTY,YUBA COMMUNITY COLL DIST PD,6,3,0,9
YUBA COUNTY,**GRAND TOTAL,83026,6043,7205,96274
