County,Agency,Sworn,Reserve,Dispatcher,Total
ALAMEDA COUNTY,ALAMEDA CO SD/CORONER,941,14,32,987
ALAMEDA COUNTY,ALAMEDA PD,72,0,16,88
ALAMEDA COUNTY,ALBANY PD,24,2,6,32
ALAMEDA COUNTY,BAY AREA RAPID TRANSIT PD,216,0,21,237
ALAMEDA COUNTY,BERKELEY PD,167,16,30,213
ALAMEDA COUNTY,CSU EAST BAY PD,10,0,2,12
ALAMEDA COUNTY,EAST BAY REG PARK DPS,58,0,16,74
ALAMEDA COUNTY,EMERYVILLE PD,38,0,14,52
ALAMEDA COUNTY,FREMONT PD,184,9,30,223
ALAMEDA COUNTY,HAYWARD PD,174,22,32,228
ALAMEDA COUNTY,LIVERMORE PD,95,5,19,119
ALAMEDA COUNTY,NEWARK PD,52,2,11,65
ALAMEDA COUNTY,OAKLAND CITY HOUSING AUTH PD,27,1,0,28
ALAMEDA COUNTY,OAKLAND PD,757,5,69,831
ALAMEDA COUNTY,OAKLAND USD PD,10,0,0,10
ALAMEDA COUNTY,OHLONE CCD PD,2,1,0,3
ALAMEDA COUNTY,PIEDMONT PD,20,4,7,31
ALAMEDA COUNTY,PLEASANTON PD,80,1,16,97
ALAMEDA COUNTY,SAN LEANDRO PD,88,0,18,106
ALAMEDA COUNTY,UC BERKELEY PD,47,0,9,56
ALAMEDA COUNTY,UNION CITY PD,73,0,1,74
ALPINE COUNTY,ALPINE CO SD,13,1,1,15
AMADOR COUNTY,AMADOR CO DA,9,0,0,9
AMADOR COUNTY,AMADOR CO SD/CORONER,45,7,10,62
AMADOR COUNTY,IONE PD,9,1,0,10
AMADOR COUNTY,JACKSON PD,9,7,0,16
AMADOR COUNTY,SUTTER CREEK PD,5,3,0,8
BUTTE COUNTY,BUTTE CCD PD,4,0,0,4
BUTTE COUNTY,BUTTE CO DA,20,0,0,20
BUTTE COUNTY,BUTTE CO SD/CORONER,164,25,17,206
BUTTE COUNTY,CHICO PD,97,0,21,118
BUTTE COUNTY,CSU CHICO PD,16,0,5,21
BUTTE COUNTY,GRIDLEY PD,12,7,9,28
BUTTE COUNTY,OROVILLE PD,24,5,11,40
BUTTE COUNTY,PARADISE PD,19,0,7,26
CALAVERAS COUNTY,ANGELS CAMP PD,6,0,0,6
CALAVERAS COUNTY,CALAVERAS CO DA,2,0,0,2
CALAVERAS COUNTY,CALAVERAS CO SD,63,4,9,76
COLUSA COUNTY,COLUSA CO DISTRICT ATTORNEY,3,0,0,3
COLUSA COUNTY,COLUSA COUNTY SD,28,0,8,36
COLUSA COUNTY,COLUSA PD,7,1,0,8
COLUSA COUNTY,WILLIAMS PD,10,0,0,10
CONTRA COSTA COUNTY,ANTIOCH PD,115,2,16,133
CONTRA COSTA COUNTY,BRENTWOOD PD,64,0,13,77
CONTRA COSTA COUNTY,CLAYTON PD,11,0,0,11
CONTRA COSTA COUNTY,CONCORD PD,143,9,18,170
CONTRA COSTA COUNTY,CONTRA COSTA CCD PD,21,0,0,21
CONTRA COSTA COUNTY,CONTRA COSTA CO DA,31,0,0,31
CONTRA COSTA COUNTY,CONTRA COSTA CO SD/CORONER,626,27,46,699
CONTRA COSTA COUNTY,EL CERRITO PD,39,1,0,40
CONTRA COSTA COUNTY,HERCULES PD,23,4,0,27
CONTRA COSTA COUNTY,KENSINGTON PD,7,0,0,7
CONTRA COSTA COUNTY,MARTINEZ PD,35,5,9,49
CONTRA COSTA COUNTY,MORAGA PD,11,3,0,14
CONTRA COSTA COUNTY,OAKLEY PD,30,0,0,30
CONTRA COSTA COUNTY,PINOLE PD,25,0,12,37
CONTRA COSTA COUNTY,PITTSBURG PD,85,0,0,85
CONTRA COSTA COUNTY,PLEASANT HILL PD,43,1,11,55
CONTRA COSTA COUNTY,RICHMOND PD,150,3,20,173
CONTRA COSTA COUNTY,SAN PABLO PD,57,0,0,57
CONTRA COSTA COUNTY,SAN RAMON PD,64,0,0,64
CONTRA COSTA COUNTY,WALNUT CREEK PD,82,32,17,131
DEL NORTE COUNTY,CRESCENT CITY PD,12,0,0,12
DEL NORTE COUNTY,DEL NORTE CO DA,2,0,0,2
DEL NORTE COUNTY,DEL NORTE COUNTY SD,15,5,5,25
EL DORADO COUNTY,EL DORADO CO DA,17,0,0,17
EL DORADO COUNTY,EL DORADO CO SD,159,4,23,186
EL DORADO COUNTY,PLACERVILLE PD,17,2,5,24
EL DORADO COUNTY,SOUTH LAKE TAHOE PD,39,3,10,52
FRESNO COUNTY,CLOVIS PD,100,9,23,132
FRESNO COUNTY,CLOVIS UNIF SCHL DIST PD,16,0,0,16
FRESNO COUNTY,COALINGA PD,16,0,3,19
FRESNO COUNTY,CSU FRESNO DPS,26,0,8,34
FRESNO COUNTY,FIREBAUGH PD,11,8,0,19
FRESNO COUNTY,FOWLER PD,11,1,0,12
FRESNO COUNTY,FRESNO CO DA,52,0,0,52
FRESNO COUNTY,FRESNO CO SD,410,67,48,525
FRESNO COUNTY,FRESNO PD,797,20,100,917
FRESNO COUNTY,FRESNO YOSEMITE INT'L AIRPORT,6,0,0,6
FRESNO COUNTY,HURON PD,18,0,6,24
FRESNO COUNTY,KERMAN PD,22,6,0,28
FRESNO COUNTY,KINGSBURG PD,18,7,0,25
FRESNO COUNTY,MENDOTA PD,13,6,0,19
FRESNO COUNTY,ORANGE COVE PD,11,3,0,14
FRESNO COUNTY,PARLIER PD,16,2,0,18
FRESNO COUNTY,REEDLEY PD,28,2,7,37
FRESNO COUNTY,SANGER PD,35,1,0,36
FRESNO COUNTY,SELMA PD,34,0,7,41
FRESNO COUNTY,STATE CENTER CCD PD,18,0,7,25
GLENN COUNTY,GLENN CO DA,1,0,0,1
GLENN COUNTY,GLENN CO SD/CORONER,46,4,9,59
GLENN COUNTY,ORLAND PD,12,1,0,13
HUMBOLDT COUNTY,ARCATA PD,25,0,7,32
HUMBOLDT COUNTY,CSU HUMBOLDT PD,12,0,7,19
HUMBOLDT COUNTY,EUREKA PD,48,3,12,63
HUMBOLDT COUNTY,FERNDALE PD,7,2,0,9
HUMBOLDT COUNTY,FORTUNA PD,18,0,6,24
HUMBOLDT COUNTY,HUMBOLDT CO DA,10,0,0,10
HUMBOLDT COUNTY,HUMBOLDT CO SD,189,16,13,218
HUMBOLDT COUNTY,HUMBOLDT DEPT WELFARE/INVEST,9,0,0,9
HUMBOLDT COUNTY,RIO DELL PD,4,1,0,5
IMPERIAL COUNTY,BRAWLEY PD,23,6,7,36
IMPERIAL COUNTY,CALEXICO PD,22,2,7,31
IMPERIAL COUNTY,CALIPATRIA PD,6,2,0,8
IMPERIAL COUNTY,EL CENTRO PD,46,1,11,58
IMPERIAL COUNTY,IMPERIAL CO DA,17,0,0,17
IMPERIAL COUNTY,IMPERIAL CO SD,94,10,11,115
IMPERIAL COUNTY,IMPERIAL PD,15,3,0,18
IMPERIAL COUNTY,WESTMORLAND PD,4,3,0,7
INYO COUNTY,BISHOP PD,11,4,7,22
INYO COUNTY,INYO CO DA,2,0,0,2
INYO COUNTY,INYO COUNTY SD,37,8,6,51
KERN COUNTY,ARVIN PD,18,4,5,27
KERN COUNTY,BAKERSFIELD PD,410,6,38,454
KERN COUNTY,BEAR VALLEY PD,5,0,0,5
KERN COUNTY,CALIFORNIA CITY PD,14,7,5,26
KERN COUNTY,CSU BAKERSFIELD DPS,14,0,7,21
KERN COUNTY,DELANO PD,50,2,8,60
KERN COUNTY,KERN CO DA,28,0,0,28
KERN COUNTY,KERN CO-DEPT OF PARKS & REC,8,1,0,9
KERN COUNTY,KERN COUNTY SD,772,38,42,852
KERN COUNTY,KERN HIGH SCHOOL DISTRICT PD,29,0,0,29
KERN COUNTY,MCFARLAND PD,8,1,5,14
KERN COUNTY,RIDGECREST PD,30,11,5,46
KERN COUNTY,SHAFTER PD,28,0,7,35
KERN COUNTY,STALLION SPRINGS PD,4,0,0,4
KERN COUNTY,TAFT PD,13,2,5,20
KERN COUNTY,TEHACHAPI PD,16,2,8,26
KINGS COUNTY,AVENAL PD,17,2,0,19
KINGS COUNTY,CORCORAN PD,19,3,10,32
KINGS COUNTY,HANFORD PD,60,0,13,73
KINGS COUNTY,KINGS CO DA,14,0,0,14
KINGS COUNTY,KINGS CO SHERIFF'S OFFICE,201,5,15,221
KINGS COUNTY,"KINGS CO-HUMAN SVCS,WELFARE FD",3,0,0,3
KINGS COUNTY,LEMOORE PD,32,6,0,38
LAKE COUNTY,CLEARLAKE PD,22,2,7,31
LAKE COUNTY,LAKE CO DA,5,0,0,5
LAKE COUNTY,LAKE CO SD,89,1,8,98
LAKE COUNTY,LAKEPORT PD,9,0,0,9
LASSEN COUNTY,LASSEN CO DA,1,0,0,1
LASSEN COUNTY,LASSEN CO SD,61,3,6,70
LASSEN COUNTY,SUSANVILLE PD,16,0,0,16
LOS ANGELES COUNTY,ALHAMBRA PD,76,4,12,92
LOS ANGELES COUNTY,AMTRAK PD,31,0,0,31
LOS ANGELES COUNTY,ARCADIA PD,62,6,9,77
LOS ANGELES COUNTY,AZUSA PD,53,3,10,66
LOS ANGELES COUNTY,BALDWIN PARK PD,67,1,11,79
LOS ANGELES COUNTY,BALDWIN PARK UNIF SCH DIST PD,8,0,0,8
LOS ANGELES COUNTY,BELL GARDENS PD,46,2,7,55
LOS ANGELES COUNTY,BELL PD,30,3,4,37
LOS ANGELES COUNTY,BEVERLY HILLS PD,134,8,20,162
LOS ANGELES COUNTY,BURBANK AIRPORT AUTH PD,34,0,0,34
LOS ANGELES COUNTY,BURBANK PD,138,13,17,168
LOS ANGELES COUNTY,CA DEPT INDUSTRIAL RELATIONS,3,0,0,3
LOS ANGELES COUNTY,CA DEPT OF BUSINESS OVERSIGHT,5,0,0,5
LOS ANGELES COUNTY,CERRITOS CCD PD,14,0,0,14
LOS ANGELES COUNTY,CLAREMONT PD,38,3,8,49
LOS ANGELES COUNTY,COMPTON CCD PD,4,0,2,6
LOS ANGELES COUNTY,COMPTON UNIF SCH DIST PD,18,0,0,18
LOS ANGELES COUNTY,COVINA PD,54,1,10,65
LOS ANGELES COUNTY,CSU DOMINGUEZ HILLS PD,19,0,8,27
LOS ANGELES COUNTY,CSU LONG BEACH PD,21,0,10,31
LOS ANGELES COUNTY,CSU LOS ANGELES DPS,18,0,5,23
LOS ANGELES COUNTY,CSU NORTHRIDGE DEPT POLICE SVS,19,0,6,25
LOS ANGELES COUNTY,CSU POMONA DPS,23,0,6,29
LOS ANGELES COUNTY,CULVER CITY PD,113,16,0,129
LOS ANGELES COUNTY,DOWNEY PD,119,0,15,134
LOS ANGELES COUNTY,EL CAMINO CCD PD,11,1,5,17
LOS ANGELES COUNTY,EL MONTE PD,118,22,14,154
LOS ANGELES COUNTY,EL SEGUNDO PD,54,0,0,54
LOS ANGELES COUNTY,GARDENA PD,85,4,0,89
LOS ANGELES COUNTY,GLENDALE CCD PD,9,0,0,9
LOS ANGELES COUNTY,GLENDALE PD,228,11,20,259
LOS ANGELES COUNTY,GLENDORA PD,47,3,10,60
LOS ANGELES COUNTY,HACIENDA LA PUENTE USD,5,0,0,5
LOS ANGELES COUNTY,HAWTHORNE PD,90,2,0,92
LOS ANGELES COUNTY,HERMOSA BEACH PD,33,1,0,34
LOS ANGELES COUNTY,HUNTINGTON PARK PD,55,4,7,66
LOS ANGELES COUNTY,INGLEWOOD PD,192,0,20,212
LOS ANGELES COUNTY,INGLEWOOD UNIF SCH DIST PD,2,2,0,4
LOS ANGELES COUNTY,IRWINDALE PD,27,3,6,36
LOS ANGELES COUNTY,LA VERNE PD,37,5,7,49
LOS ANGELES COUNTY,LONG BEACH DISASTER/EMERG COMM,0,0,46,46
LOS ANGELES COUNTY,LONG BEACH PD,836,22,0,858
LOS ANGELES COUNTY,LOS ANGELES CITY PARK RANGER,21,0,0,21
LOS ANGELES COUNTY,LOS ANGELES CO CORONER,55,0,0,55
LOS ANGELES COUNTY,LOS ANGELES CO DA,241,0,0,241
LOS ANGELES COUNTY,LOS ANGELES CO SD,9837,572,512,10921
LOS ANGELES COUNTY,LOS ANGELES PD,9722,393,580,10695
LOS ANGELES COUNTY,LOS ANGELES PORT PD,133,0,8,141
LOS ANGELES COUNTY,LOS ANGELES SCHOOL PD,340,0,0,340
LOS ANGELES COUNTY,LOS ANGELES WORLD AIRPORTS PD,514,0,0,514
LOS ANGELES COUNTY,MANHATTAN BEACH PD,61,1,0,62
LOS ANGELES COUNTY,MONROVIA PD,42,2,12,56
LOS ANGELES COUNTY,MONTEBELLO PD,72,7,9,88
LOS ANGELES COUNTY,MONTEBELLO UNIFIED SCHOOL DIST,3,0,0,3
LOS ANGELES COUNTY,MONTEREY PARK PD,66,18,14,98
LOS ANGELES COUNTY,PALOS VERDES ESTATES PD,19,6,7,32
LOS ANGELES COUNTY,PASADENA CITY CCD PD,10,0,7,17
LOS ANGELES COUNTY,PASADENA PD,214,9,29,252
LOS ANGELES COUNTY,POMONA PD,148,7,27,182
LOS ANGELES COUNTY,REDONDO BEACH PD,83,12,11,106
LOS ANGELES COUNTY,SAN FERNANDO PD,28,17,7,52
LOS ANGELES COUNTY,SAN GABRIEL PD,53,3,5,61
LOS ANGELES COUNTY,SAN MARINO PD,27,0,5,32
LOS ANGELES COUNTY,SANTA MONICA CCD PD,17,0,7,24
LOS ANGELES COUNTY,SANTA MONICA OFFICE EMER MGT,0,0,27,27
LOS ANGELES COUNTY,SANTA MONICA PD,212,0,0,212
LOS ANGELES COUNTY,SIERRA MADRE PD,16,7,6,29
LOS ANGELES COUNTY,SIGNAL HILL PD,31,0,8,39
LOS ANGELES COUNTY,SOUTH BAY REG PUB COMM AUTH,0,0,63,63
LOS ANGELES COUNTY,SOUTH GATE PD,72,1,9,82
LOS ANGELES COUNTY,SOUTH PASADENA PD,33,4,9,46
LOS ANGELES COUNTY,TORRANCE PD,200,0,23,223
LOS ANGELES COUNTY,UC LOS ANGELES PD,53,0,14,67
LOS ANGELES COUNTY,VERNON PD,41,1,7,49
LOS ANGELES COUNTY,WEST COVINA PD,89,6,17,112
LOS ANGELES COUNTY,WHITTIER PD,105,1,14,120
MADERA COUNTY,CHOWCHILLA PD,19,2,8,29
MADERA COUNTY,MADERA CO DA,9,0,0,9
MADERA COUNTY,MADERA CO SD,83,25,10,118
MADERA COUNTY,MADERA PD,67,1,14,82
MARIN COUNTY,BELVEDERE PD,7,1,0,8
MARIN COUNTY,CENTRAL MARIN POLICE AUTHORITY,42,2,0,44
MARIN COUNTY,FAIRFAX PD,9,0,4,13
MARIN COUNTY,MARIN CCD PD,5,0,0,5
MARIN COUNTY,MARIN CO DA,12,0,0,12
MARIN COUNTY,MARIN CO HEALTH & HUMAN SVCS,3,0,0,3
MARIN COUNTY,MARIN CO SD,199,0,41,240
MARIN COUNTY,MARIN MUNCPL WATER DIST,6,0,0,6
MARIN COUNTY,MILL VALLEY PD,21,1,0,22
MARIN COUNTY,NOVATO PD,53,0,11,64
MARIN COUNTY,ROSS PD,7,0,0,7
MARIN COUNTY,SAN RAFAEL PD,61,3,22,86
MARIN COUNTY,SAUSALITO PD,19,0,0,19
MARIN COUNTY,TIBURON PD,14,8,0,22
MARIPOSA COUNTY,MARIPOSA CO DA,1,0,0,1
MARIPOSA COUNTY,MARIPOSA CO SD,60,12,0,72
MENDOCINO COUNTY,FORT BRAGG PD,12,0,0,12
MENDOCINO COUNTY,MENDOCINO CO DA,7,0,0,7
MENDOCINO COUNTY,MENDOCINO CO HEALTH/HUMAN SVCS,6,0,0,6
MENDOCINO COUNTY,MENDOCINO CO SD,120,7,13,140
MENDOCINO COUNTY,UKIAH PD,25,0,12,37
MENDOCINO COUNTY,WILLITS PD,10,1,5,16
MERCED COUNTY,ATWATER PD,24,6,5,35
MERCED COUNTY,DOS PALOS PD,11,1,4,16
MERCED COUNTY,GUSTINE PD,8,1,0,9
MERCED COUNTY,LIVINGSTON PD,18,2,7,27
MERCED COUNTY,LOS BANOS PD,32,1,9,42
MERCED COUNTY,MERCED CCD PD,5,0,0,5
MERCED COUNTY,MERCED CO DA,9,0,0,9
MERCED COUNTY,MERCED CO SD,117,48,16,181
MERCED COUNTY,MERCED PD,86,7,13,106
MERCED COUNTY,UC MERCED PD,18,0,6,24
MODOC COUNTY,ALTURAS PD,9,3,0,12
MODOC COUNTY,MODOC CO SD,11,0,4,15
MONO COUNTY,MAMMOTH LAKES PD,15,1,0,16
MONO COUNTY,MONO CO DA,2,0,0,2
MONO COUNTY,MONO CO SD,22,0,16,38
MONTEREY COUNTY,CARMEL PD,14,0,5,19
MONTEREY COUNTY,CSU MONTEREY BAY PD,16,0,0,16
MONTEREY COUNTY,DEL REY OAKS PD,10,5,0,15
MONTEREY COUNTY,GONZALES PD,12,0,0,12
MONTEREY COUNTY,GREENFIELD PD,20,2,0,22
MONTEREY COUNTY,KING CITY PD,15,0,0,15
MONTEREY COUNTY,MARINA PD,28,0,0,28
MONTEREY COUNTY,MONTEREY CO DA,28,0,0,28
MONTEREY COUNTY,MONTEREY CO EMER COMM,0,0,61,61
MONTEREY COUNTY,MONTEREY CO SHERIFF'S OFFICE,292,3,0,295
MONTEREY COUNTY,MONTEREY PD,46,1,0,47
MONTEREY COUNTY,PACIFIC GROVE PD,19,0,0,19
MONTEREY COUNTY,SALINAS PD,146,0,0,146
MONTEREY COUNTY,SAND CITY PD,10,3,0,13
MONTEREY COUNTY,SEASIDE PD,30,0,0,30
MONTEREY COUNTY,SOLEDAD PD,17,6,0,23
NAPA COUNTY,CALISTOGA PD,11,0,8,19
NAPA COUNTY,NAPA CO DA,12,0,0,12
NAPA COUNTY,NAPA CO SD,100,0,0,100
NAPA COUNTY,NAPA PD,74,0,29,103
NAPA COUNTY,NAPA VALLEY COLLEGE DPS,4,0,0,4
NAPA COUNTY,NAPA VALLEY RR PD,2,0,0,2
NAPA COUNTY,SAINT HELENA PD,11,1,6,18
NEVADA COUNTY,GRASS VALLEY PD,27,8,0,35
NEVADA COUNTY,NEVADA CITY PD,10,5,0,15
NEVADA COUNTY,NEVADA CO DA,5,0,0,5
NEVADA COUNTY,NEVADA CO SD,60,2,13,75
NEVADA COUNTY,TRUCKEE PD,23,1,0,24
ORANGE COUNTY,ANAHEIM PD,391,24,32,447
ORANGE COUNTY,BREA PD,57,0,13,70
ORANGE COUNTY,BUENA PARK PD,87,4,14,105
ORANGE COUNTY,COAST CCD PD,1,0,0,1
ORANGE COUNTY,COSTA MESA PD,128,4,27,159
ORANGE COUNTY,CSU FULLERTON PD,27,0,11,38
ORANGE COUNTY,CYPRESS PD,47,0,0,47
ORANGE COUNTY,FOUNTAIN VALLEY PD,62,0,12,74
ORANGE COUNTY,FULLERTON PD,122,4,17,143
ORANGE COUNTY,GARDEN GROVE PD,173,8,20,201
ORANGE COUNTY,HUNTINGTON BEACH PD,208,5,26,239
ORANGE COUNTY,IRVINE PD,218,1,21,240
ORANGE COUNTY,IRVINE VALLEY CCD PD,9,0,4,13
ORANGE COUNTY,LA HABRA PD,68,6,17,91
ORANGE COUNTY,LA PALMA PD,19,4,9,32
ORANGE COUNTY,LAGUNA BEACH PD,53,3,13,69
ORANGE COUNTY,LOS ALAMITOS PD,18,2,0,20
ORANGE COUNTY,NEWPORT BEACH PD,137,3,20,160
ORANGE COUNTY,ORANGE CO DA,175,0,0,175
ORANGE COUNTY,ORANGE CO SD/CORONER,1909,137,54,2100
ORANGE COUNTY,ORANGE PD,152,5,17,174
ORANGE COUNTY,PLACENTIA PD,46,1,13,60
ORANGE COUNTY,SADDLEBACK CCD PD,7,0,2,9
ORANGE COUNTY,SANTA ANA PD,332,4,34,370
ORANGE COUNTY,SANTA ANA UNIF SCHL DIST PD,28,0,0,28
ORANGE COUNTY,SEAL BEACH PD,38,1,0,39
ORANGE COUNTY,TUSTIN PD,91,6,15,112
ORANGE COUNTY,UC IRVINE PD,47,0,11,58
ORANGE COUNTY,WEST CITIES COMM CTR,0,0,21,21
ORANGE COUNTY,WESTMINSTER PD,85,6,12,103
PLACER COUNTY,AUBURN PD,20,2,8,30
PLACER COUNTY,LINCOLN PD,24,0,6,30
PLACER COUNTY,PLACER CO DA,18,2,0,20
PLACER COUNTY,PLACER COUNTY SD,250,91,21,362
PLACER COUNTY,ROCKLIN PD,59,2,12,73
PLACER COUNTY,ROSEVILLE PD,137,3,23,163
PLACER COUNTY,UNION PACIFIC RAILROAD,33,0,0,33
PLUMAS COUNTY,PLUMAS CO SD,32,5,11,48
RIVERSIDE COUNTY,BANNING PD,26,2,7,35
RIVERSIDE COUNTY,BEAUMONT PD,41,0,11,52
RIVERSIDE COUNTY,BLYTHE PD,17,2,7,26
RIVERSIDE COUNTY,CATHEDRAL CITY PD,48,1,17,66
RIVERSIDE COUNTY,CORONA PD,145,0,28,173
RIVERSIDE COUNTY,DESERT HOT SPRINGS PD,29,1,0,30
RIVERSIDE COUNTY,HEMET PD,71,0,16,87
RIVERSIDE COUNTY,INDIO PD,72,0,13,85
RIVERSIDE COUNTY,MENIFEE PD,44,0,0,44
RIVERSIDE COUNTY,MURRIETA PD,94,5,35,134
RIVERSIDE COUNTY,PALM SPRINGS PD,98,4,16,118
RIVERSIDE COUNTY,RIVERSIDE CCD PD,21,0,0,21
RIVERSIDE COUNTY,RIVERSIDE CO DA,111,0,2,113
RIVERSIDE COUNTY,RIVERSIDE CO PUBLIC SOCIAL SER,20,0,0,20
RIVERSIDE COUNTY,RIVERSIDE CO SD,1837,34,155,2026
RIVERSIDE COUNTY,RIVERSIDE PD,364,0,54,418
RIVERSIDE COUNTY,UC RIVERSIDE PD,31,0,7,38
RIVERSIDE COUNTY,VAL VERDE UNIF SCH DIST PD,6,6,0,12
SACRAMENTO COUNTY,CA ALCOHOLIC BEVERAGE CONTROL,178,0,0,178
SACRAMENTO COUNTY,CA ASSEMBLY SGT AT ARMS LEGIS,23,0,0,23
SACRAMENTO COUNTY,CA DEPT CONSUMER AFF DEN BD,15,0,0,15
SACRAMENTO COUNTY,CA DEPT CONSUMER AFF INVEST,179,0,0,179
SACRAMENTO COUNTY,CA DEPT DEVELOPMENTAL OPS,87,0,0,87
SACRAMENTO COUNTY,CA DEPT EMPLOYMENT DEVELOPMENT,34,0,0,34
SACRAMENTO COUNTY,CA DEPT FISH & WILDLIFE,389,0,0,389
SACRAMENTO COUNTY,CA DEPT HEALTH CARE SVCS,74,0,0,74
SACRAMENTO COUNTY,CA DEPT INSURANCE FRAUD,186,0,0,186
SACRAMENTO COUNTY,CA DEPT JUSTICE,265,0,0,265
SACRAMENTO COUNTY,CA DEPT MOTOR VEHICLES,207,0,0,207
SACRAMENTO COUNTY,CA DEPT OF MANAGED HEALTH CARE,1,0,0,1
SACRAMENTO COUNTY,CA DEPT PARKS & RECREATION,480,0,40,520
SACRAMENTO COUNTY,CA DEPT PUB HEALTH FOOD/DRUG,84,0,0,84
SACRAMENTO COUNTY,CA DEPT SOCIAL SERVICES,57,0,0,57
SACRAMENTO COUNTY,CA DEPT STATE HOSPITALS,40,0,0,40
SACRAMENTO COUNTY,CA DEPT TOXIC SUBSTANCES CNTL,11,0,0,11
SACRAMENTO COUNTY,CA FRANCHISE TAX BOARD,31,0,0,31
SACRAMENTO COUNTY,CA HIGHWAY PATROL,7133,0,896,8029
SACRAMENTO COUNTY,CA HORSE RACING BOARD,13,0,0,13
SACRAMENTO COUNTY,CA OFFICE OF LE SUPPORT (OLES),5,0,0,5
SACRAMENTO COUNTY,CA SECRETARY OF STATE OFC INV,3,0,0,3
SACRAMENTO COUNTY,CA STATE FAIR PD,5,1,0,6
SACRAMENTO COUNTY,CA STATE LOTTERY,32,0,0,32
SACRAMENTO COUNTY,CAL - OES,17,0,0,17
SACRAMENTO COUNTY,CAL FIRE,166,0,0,166
SACRAMENTO COUNTY,CITRUS HEIGHTS PD,85,10,21,116
SACRAMENTO COUNTY,CSU SACRAMENTO UNIVERSITY PD,23,0,7,30
SACRAMENTO COUNTY,ELK GROVE PD,138,0,21,159
SACRAMENTO COUNTY,FOLSOM PD,74,4,15,93
SACRAMENTO COUNTY,GALT PD,31,2,6,39
SACRAMENTO COUNTY,LOS RIOS CCD PD,21,0,4,25
SACRAMENTO COUNTY,SACRAMENTO CO CORONER,18,0,0,18
SACRAMENTO COUNTY,SACRAMENTO CO DA,36,0,0,36
SACRAMENTO COUNTY,SACRAMENTO CO HUMAN ASST INV,19,0,0,19
SACRAMENTO COUNTY,SACRAMENTO CO REG PARKS DEPT,34,3,0,37
SACRAMENTO COUNTY,SACRAMENTO CO SD,1357,376,69,1802
SACRAMENTO COUNTY,SACRAMENTO PD,679,103,95,877
SACRAMENTO COUNTY,TWIN RIVERS USD PD,15,5,4,24
SAN BENITO COUNTY,HOLLISTER PD,33,2,0,35
SAN BENITO COUNTY,SAN BENITO CO DA,2,0,0,2
SAN BENITO COUNTY,SAN BENITO CO SD,53,12,0,65
SAN BERNARDINO COUNTY,APPLE VALLEY UNIF SCH DIST PD,9,4,0,13
SAN BERNARDINO COUNTY,BARSTOW PD,39,2,10,51
SAN BERNARDINO COUNTY,BURLINGTON NORTHRN SANTA FE RR,36,0,0,36
SAN BERNARDINO COUNTY,CHAFFEY CCD PD,13,0,0,13
SAN BERNARDINO COUNTY,CHINO PD,105,1,19,125
SAN BERNARDINO COUNTY,COLTON PD,53,0,12,65
SAN BERNARDINO COUNTY,CSU SAN BERNARDINO PD,19,0,8,27
SAN BERNARDINO COUNTY,FONTANA PD,183,1,27,211
SAN BERNARDINO COUNTY,FONTANA UNIFIED SCHOOL DIST,17,0,10,27
SAN BERNARDINO COUNTY,HESPERIA UNIFIED SCHOOL DIST,9,0,0,9
SAN BERNARDINO COUNTY,MONTCLAIR PD,37,6,9,52
SAN BERNARDINO COUNTY,ONTARIO PD,291,8,37,336
SAN BERNARDINO COUNTY,REDLANDS PD,83,3,18,104
SAN BERNARDINO COUNTY,RIALTO PD,100,1,10,111
SAN BERNARDINO COUNTY,SAN BERNARDINO CCD PD,9,1,1,11
SAN BERNARDINO COUNTY,SAN BERNARDINO CO DA,59,0,0,59
SAN BERNARDINO COUNTY,SAN BERNARDINO CO HUMAN SVCS,24,0,0,24
SAN BERNARDINO COUNTY,SAN BERNARDINO CO SD,1951,153,182,2286
SAN BERNARDINO COUNTY,SAN BERNARDINO PD,240,14,25,279
SAN BERNARDINO COUNTY,SAN BERNARDINO UNIF SCHL DIST,26,2,9,37
SAN BERNARDINO COUNTY,SNOWLINE JOINT UNIF SCHL DIST,3,2,0,5
SAN BERNARDINO COUNTY,UPLAND PD,64,5,12,81
SAN BERNARDINO COUNTY,VICTOR VALLEY COLLEGE PD,7,3,0,10
SAN DIEGO COUNTY,CARLSBAD PD,129,1,21,151
SAN DIEGO COUNTY,CHULA VISTA PD,233,2,28,263
SAN DIEGO COUNTY,CORONADO PD,47,2,9,58
SAN DIEGO COUNTY,CSU SAN DIEGO PD,31,0,9,40
SAN DIEGO COUNTY,CSU SAN MARCOS DPS,16,0,6,22
SAN DIEGO COUNTY,EL CAJON PD,122,20,19,161
SAN DIEGO COUNTY,ESCONDIDO PD,151,6,27,184
SAN DIEGO COUNTY,LA MESA PD,64,1,21,86
SAN DIEGO COUNTY,MIRA COSTA CCD PD,9,0,4,13
SAN DIEGO COUNTY,NATIONAL CITY PD,80,3,13,96
SAN DIEGO COUNTY,OCEANSIDE PD,205,1,29,235
SAN DIEGO COUNTY,PALOMAR CCD PD,11,4,0,15
SAN DIEGO COUNTY,SAN DIEGO CCD PD,35,0,11,46
SAN DIEGO COUNTY,SAN DIEGO CITY SCHOOLS PD,38,0,10,48
SAN DIEGO COUNTY,SAN DIEGO CO DA,131,0,0,131
SAN DIEGO COUNTY,SAN DIEGO CO PUBLIC ASST INV,43,0,0,43
SAN DIEGO COUNTY,SAN DIEGO CO SD,2676,64,145,2885
SAN DIEGO COUNTY,"SAN DIEGO HARBOR PD, PORT OF",129,0,13,142
SAN DIEGO COUNTY,SAN DIEGO PD,1838,18,171,2027
SAN DIEGO COUNTY,SOUTHWESTERN CCD PD,10,0,0,10
SAN DIEGO COUNTY,UC SAN DIEGO PD,38,0,10,48
SAN FRANCISCO COUNTY,CSU SAN FRANCISCO PD,20,0,5,25
SAN FRANCISCO COUNTY,SAN FRAN INT'L AIRPORT COMM,0,0,35,35
SAN FRANCISCO COUNTY,SAN FRANCISCO CCD PD,19,0,1,20
SAN FRANCISCO COUNTY,SAN FRANCISCO CO DA,38,0,0,38
SAN FRANCISCO COUNTY,SAN FRANCISCO CO MED EXAM,15,0,0,15
SAN FRANCISCO COUNTY,SAN FRANCISCO CO SD,833,0,0,833
SAN FRANCISCO COUNTY,SAN FRANCISCO DEPT EMER MGT,1,0,217,218
SAN FRANCISCO COUNTY,SAN FRANCISCO PD,2179,32,0,2211
SAN FRANCISCO COUNTY,UC SAN FRANCISCO PD,55,0,8,63
SAN JOAQUIN COUNTY,ESCALON PD,12,11,0,23
SAN JOAQUIN COUNTY,LODI PD,70,6,17,93
SAN JOAQUIN COUNTY,MANTECA PD,73,4,12,89
SAN JOAQUIN COUNTY,PORT OF STOCKTON PD,16,0,0,16
SAN JOAQUIN COUNTY,RIPON PD,22,0,6,28
SAN JOAQUIN COUNTY,SAN JOAQUIN CO DA,39,0,0,39
SAN JOAQUIN COUNTY,SAN JOAQUIN CO SD,297,3,29,329
SAN JOAQUIN COUNTY,SAN JOAQUIN DELTA COLLEGE PD,13,1,5,19
SAN JOAQUIN COUNTY,STOCKTON PD,438,32,47,517
SAN JOAQUIN COUNTY,STOCKTON UNIF SCHL DIST PD,34,1,8,43
SAN JOAQUIN COUNTY,TRACY PD,94,2,18,114
SAN LUIS OBISPO COUNTY,ARROYO GRANDE PD,23,1,0,24
SAN LUIS OBISPO COUNTY,ATASCADERO PD,29,0,5,34
SAN LUIS OBISPO COUNTY,CPSU SAN LUIS OBISPO PD,17,0,8,25
SAN LUIS OBISPO COUNTY,CUESTA CCD DPS,7,0,0,7
SAN LUIS OBISPO COUNTY,GROVER BEACH PD,17,1,8,26
SAN LUIS OBISPO COUNTY,MORRO BAY PD,17,0,0,17
SAN LUIS OBISPO COUNTY,PASO ROBLES PD,36,3,8,47
SAN LUIS OBISPO COUNTY,PISMO BEACH PD,20,1,8,29
SAN LUIS OBISPO COUNTY,SAN LUIS OBISPO CO DA,17,0,0,17
SAN LUIS OBISPO COUNTY,SAN LUIS OBISPO CO SD,320,12,23,355
SAN LUIS OBISPO COUNTY,SAN LUIS OBISPO PD,61,3,14,78
SAN MATEO COUNTY,ATHERTON PD,18,5,10,33
SAN MATEO COUNTY,BELMONT PD,31,0,11,42
SAN MATEO COUNTY,BRISBANE PD,13,0,0,13
SAN MATEO COUNTY,BROADMOOR PD,10,17,0,27
SAN MATEO COUNTY,BURLINGAME PD,39,0,15,54
SAN MATEO COUNTY,COLMA PD,18,2,5,25
SAN MATEO COUNTY,DALY CITY PD,91,0,1,92
SAN MATEO COUNTY,EAST PALO ALTO PD,34,0,0,34
SAN MATEO COUNTY,FOSTER CITY PD,38,3,9,50
SAN MATEO COUNTY,HILLSBOROUGH PD,27,1,6,34
SAN MATEO COUNTY,MENLO PARK PD,48,4,13,65
SAN MATEO COUNTY,PACIFICA PD,31,5,0,36
SAN MATEO COUNTY,REDWOOD CITY PD,82,4,18,104
SAN MATEO COUNTY,SAN BRUNO PD,45,5,12,62
SAN MATEO COUNTY,SAN MATEO CO CORONER,9,0,0,9
SAN MATEO COUNTY,SAN MATEO CO DA,18,0,0,18
SAN MATEO COUNTY,SAN MATEO CO PUB SFTY COMM CTR,0,0,72,72
SAN MATEO COUNTY,SAN MATEO CO SHERIFF'S OFFICE,314,37,0,351
SAN MATEO COUNTY,SAN MATEO PD,105,5,15,125
SAN MATEO COUNTY,SOUTH SAN FRANCISCO PD,78,5,18,101
SANTA BARBARA COUNTY,ALLAN HANCOCK CCD PD,6,2,2,10
SANTA BARBARA COUNTY,GUADALUPE PD,14,1,0,15
SANTA BARBARA COUNTY,LOMPOC PD,37,0,11,48
SANTA BARBARA COUNTY,SANTA BARBARA CO DA,13,0,0,13
SANTA BARBARA COUNTY,SANTA BARBARA CO SD,485,42,33,560
SANTA BARBARA COUNTY,SANTA BARBARA PD,129,13,14,156
SANTA BARBARA COUNTY,SANTA MARIA PD,136,1,21,158
SANTA BARBARA COUNTY,UC SANTA BARBARA PD,37,0,7,44
SANTA CLARA COUNTY,CAMPBELL PD,41,11,16,68
SANTA CLARA COUNTY,CSU SAN JOSE PD,26,0,6,32
SANTA CLARA COUNTY,FOOTHILL-DEANZA CCD PD,10,0,0,10
SANTA CLARA COUNTY,GILROY PD,71,5,11,87
SANTA CLARA COUNTY,LOS ALTOS PD,32,1,10,43
SANTA CLARA COUNTY,LOS GATOS PD,35,5,8,48
SANTA CLARA COUNTY,MILPITAS PD,86,0,15,101
SANTA CLARA COUNTY,MORGAN HILL PD,38,3,8,49
SANTA CLARA COUNTY,MOUNTAIN VIEW PD,87,11,15,113
SANTA CLARA COUNTY,PALO ALTO PD,80,9,21,110
SANTA CLARA COUNTY,SAN JOSE PD,1059,107,144,1310
SANTA CLARA COUNTY,SAN JOSE UNIF SCHL DIST PD,1,0,0,1
SANTA CLARA COUNTY,SAN JOSE/EVERGREEN CCD PD,6,4,0,10
SANTA CLARA COUNTY,SANTA CLARA CO COMM DEPT,0,0,85,85
SANTA CLARA COUNTY,SANTA CLARA CO DA,85,0,0,85
SANTA CLARA COUNTY,SANTA CLARA CO DA-WELFARE FRD,1,0,0,1
SANTA CLARA COUNTY,SANTA CLARA CO SD,1269,59,0,1328
SANTA CLARA COUNTY,SANTA CLARA PD,145,180,18,343
SANTA CLARA COUNTY,SUNNYVALE DPS,202,0,18,220
SANTA CLARA COUNTY,WEST VALLEY CCD PD,8,2,0,10
SANTA CRUZ COUNTY,CAPITOLA PD,20,2,0,22
SANTA CRUZ COUNTY,SANTA CRUZ CO DA,16,0,0,16
SANTA CRUZ COUNTY,SANTA CRUZ CO SD,157,17,0,174
SANTA CRUZ COUNTY,SANTA CRUZ PD,82,0,0,82
SANTA CRUZ COUNTY,SCOTTS VALLEY PD,17,6,7,30
SANTA CRUZ COUNTY,UC SANTA CRUZ PD,25,0,9,34
SANTA CRUZ COUNTY,WATSONVILLE PD,72,1,0,73
SHASTA COUNTY,ANDERSON PD,20,1,0,21
SHASTA COUNTY,REDDING PD,105,1,0,106
SHASTA COUNTY,SHASTA AREA SAFETY COMM AGCY,0,0,38,38
SHASTA COUNTY,SHASTA CO DA,11,0,0,11
SHASTA COUNTY,SHASTA CO MARSHAL,20,0,2,22
SHASTA COUNTY,SHASTA CO SD,123,6,0,129
SIERRA COUNTY,SIERRA CO SHERIFF'S OFFICE,6,3,4,13
SISKIYOU COUNTY,ETNA PD,4,2,0,6
SISKIYOU COUNTY,LAKE SHASTINA DISTRICT PD,3,0,0,3
SISKIYOU COUNTY,MOUNT SHASTA PD,8,3,6,17
SISKIYOU COUNTY,SISKIYOU CO DA,3,0,0,3
SISKIYOU COUNTY,SISKIYOU CO SD,72,10,10,92
SISKIYOU COUNTY,TULELAKE PD,2,1,0,3
SISKIYOU COUNTY,WEED PD,9,1,5,15
SISKIYOU COUNTY,YREKA PD,14,0,9,23
SOLANO COUNTY,BENICIA PD,32,2,13,47
SOLANO COUNTY,CSU CAL MARITIME ACADEMY PD,10,0,0,10
SOLANO COUNTY,DIXON PD,27,0,0,27
SOLANO COUNTY,FAIRFIELD PD,119,0,23,142
SOLANO COUNTY,RIO VISTA PD,1,1,0,2
SOLANO COUNTY,SOLANO CO DA,11,0,0,11
SOLANO COUNTY,SOLANO CO SD,170,11,17,198
SOLANO COUNTY,SOLANO CO SPECIAL INV BUREAU,5,0,0,5
SOLANO COUNTY,SUISUN CITY PD,23,2,9,34
SOLANO COUNTY,VACAVILLE PD,118,2,20,140
SOLANO COUNTY,VALLEJO PD,105,3,24,132
SONOMA COUNTY,CLOVERDALE PD,13,1,7,21
SONOMA COUNTY,COTATI PD,12,1,6,19
SONOMA COUNTY,CSU SONOMA PD,12,0,2,14
SONOMA COUNTY,HEALDSBURG PD,16,0,6,22
SONOMA COUNTY,PETALUMA PD,58,0,15,73
SONOMA COUNTY,ROHNERT PARK DPS,71,0,14,85
SONOMA COUNTY,SANTA ROSA PD,162,0,28,190
SONOMA COUNTY,SEBASTOPOL PD,12,4,6,22
SONOMA COUNTY,SONOMA CO DA,12,0,0,12
SONOMA COUNTY,"SONOMA CO HUM SRV,WLF FRD INV",6,0,0,6
SONOMA COUNTY,SONOMA CO JR COLLEGE DIST PD,9,0,4,13
SONOMA COUNTY,SONOMA CO SHERIFF'S OFFICE,433,0,26,459
SONOMA COUNTY,SONOMA-MARIN AREA RAIL TRANSIT,1,0,0,1
STANISLAUS COUNTY,CERES DPS,52,3,12,67
STANISLAUS COUNTY,CSU STANISLAUS DPS,13,0,1,14
STANISLAUS COUNTY,MODESTO PD,206,7,0,213
STANISLAUS COUNTY,NEWMAN PD,12,4,0,16
STANISLAUS COUNTY,OAKDALE PD,19,7,9,35
STANISLAUS COUNTY,STANISLAUS CO DA,18,0,0,18
STANISLAUS COUNTY,STANISLAUS CO SD,517,29,1,547
STANISLAUS COUNTY,STANISLAUS REGIONAL 9-1-1,1,0,53,54
STANISLAUS COUNTY,TURLOCK PD,74,1,12,87
SUTTER COUNTY,SUTTER CO DA,6,0,0,6
SUTTER COUNTY,SUTTER CO HEALTH & HUMAN SVCS,2,0,0,2
SUTTER COUNTY,SUTTER CO SD,103,9,12,124
SUTTER COUNTY,YUBA CITY PD,65,5,10,80
SUTTER COUNTY,CORNING PD,13,0,7,20
SUTTER COUNTY,RED BLUFF PD,22,3,7,32
SUTTER COUNTY,TEHAMA CO DA,7,0,0,7
SUTTER COUNTY,TEHAMA CO SD,72,9,9,90
TRINITY COUNTY,TRINITY CO DIST ATTORNEY,1,0,0,1
TRINITY COUNTY,TRINITY CO MARSHAL,4,0,0,4
TRINITY COUNTY,TRINITY COUNTY SD,29,10,2,41
TULARE COUNTY,COLLEGE OF THE SEQUOIAS PD,6,1,0,7
TULARE COUNTY,DINUBA PD,33,0,6,39
TULARE COUNTY,EXETER PD,17,5,0,22
TULARE COUNTY,FARMERSVILLE PD,15,0,0,15
TULARE COUNTY,LINDSAY DPS,15,1,0,16
TULARE COUNTY,PORTERVILLE PD,68,4,14,86
TULARE COUNTY,TULARE CO DA,35,0,0,35
TULARE COUNTY,TULARE CO SD,541,20,25,586
TULARE COUNTY,TULARE PD,68,0,11,79
TULARE COUNTY,VISALIA PD,151,0,24,175
TULARE COUNTY,WOODLAKE PD,8,4,0,12
TUOLUMNE COUNTY,SONORA PD,12,1,6,19
TUOLUMNE COUNTY,TUOLUMNE CO DA,2,0,0,2
TUOLUMNE COUNTY,TUOLUMNE CO SD,91,5,12,108
VENTURA COUNTY,CSU CHANNEL ISLANDS PD,14,0,6,20
VENTURA COUNTY,OXNARD PD,219,6,18,243
VENTURA COUNTY,PORT HUENEME PD,20,4,4,28
VENTURA COUNTY,SANTA PAULA PD,32,12,6,50
VENTURA COUNTY,SIMI VALLEY PD,121,0,16,137
VENTURA COUNTY,VENTURA CO CCD PD,14,0,0,14
VENTURA COUNTY,VENTURA CO DA,51,0,0,51
VENTURA COUNTY,VENTURA CO SD,734,12,35,781
VENTURA COUNTY,VENTURA PD,134,0,18,152
YOLO COUNTY,DAVIS PD,57,2,14,73
YOLO COUNTY,UC DAVIS PD,44,0,10,54
YOLO COUNTY,WEST SACRAMENTO PD,68,2,0,70
YOLO COUNTY,WINTERS PD,10,1,0,11
YOLO COUNTY,WOODLAND PD,66,0,0,66
YOLO COUNTY,YOLO CO COMM EMER,0,0,37,37
YOLO COUNTY,YOLO CO DA,14,0,0,14
YOLO COUNTY,YOLO CO SHERIFF'S OFFICE,82,5,0,87
YUBA COUNTY,MARYSVILLE PD,19,12,10,41
YUBA COUNTY,WHEATLAND PD,8,4,0,12
YUBA COUNTY,YUBA CO DA,2,0,0,2
YUBA COUNTY,YUBA CO SD,121,22,14,157
YUBA COUNTY,YUBA COMMUNITY COLL DIST PD,3,0,0,3
YUBA COUNTY,** GRAND TOTAL,84282,4102,8110,96494
