County,Agency,Sworn,Reserve,Dispatcher,Total
ALAMEDA COUNTY,ALAMEDA CO SD/CORONER,946,23,32,1001
ALAMEDA COUNTY,ALAMEDA PD,76,0,14,90
ALAMEDA COUNTY,ALAMEDA/CONTRA COSTA TRANSIT,1,0,0,1
ALAMEDA COUNTY,ALBANY PD,24,4,7,35
ALAMEDA COUNTY,BAY AREA RAPID TRANSIT PD,187,0,17,204
ALAMEDA COUNTY,BERKELEY PD,166,20,31,217
ALAMEDA COUNTY,CSU EAST BAY PD,14,0,6,20
ALAMEDA COUNTY,EAST BAY REG PARK DPS,56,3,14,73
ALAMEDA COUNTY,EMERYVILLE PD,36,0,13,49
ALAMEDA COUNTY,FREMONT PD,174,10,26,210
ALAMEDA COUNTY,HAYWARD PD,179,28,26,233
ALAMEDA COUNTY,LIVERMORE PD,79,7,22,108
ALAMEDA COUNTY,MORAGA PD,12,4,0,16
ALAMEDA COUNTY,NEWARK PD,56,3,12,71
ALAMEDA COUNTY,OAKLAND CITY HOUSING AUTH PD,33,3,0,36
ALAMEDA COUNTY,OAKLAND PD,647,11,66,724
ALAMEDA COUNTY,OAKLAND USD PD,17,0,0,17
ALAMEDA COUNTY,OHLONE CCD PD,2,0,0,2
ALAMEDA COUNTY,PIEDMONT PD,19,5,7,31
ALAMEDA COUNTY,PLEASANTON PD,80,1,17,98
ALAMEDA COUNTY,SAN LEANDRO PD,91,0,15,106
ALAMEDA COUNTY,UC BERKELEY PD,65,0,8,73
ALAMEDA COUNTY,UNION CITY PD,74,2,13,89
ALPINE COUNTY,ALPINE CO SD,15,0,0,15
AMADOR COUNTY,AMADOR CO DA,8,0,0,8
AMADOR COUNTY,AMADOR CO SD/CORONER,47,3,12,62
AMADOR COUNTY,IONE PD,5,0,0,5
AMADOR COUNTY,JACKSON PD,9,8,1,18
AMADOR COUNTY,SUTTER CREEK PD,5,5,0,10
BUTTE COUNTY,BUTTE CCD PD,4,0,0,4
BUTTE COUNTY,BUTTE CO DA,23,0,0,23
BUTTE COUNTY,BUTTE CO SD/CORONER,99,33,17,149
BUTTE COUNTY,CHICO PD,93,1,21,115
BUTTE COUNTY,CSU CHICO PD,15,0,6,21
BUTTE COUNTY,GRIDLEY PD,15,9,7,31
BUTTE COUNTY,OROVILLE PD,24,4,11,39
BUTTE COUNTY,PARADISE PD,21,0,11,32
CALAVERAS COUNTY,ANGELS CAMP PD,6,2,0,8
CALAVERAS COUNTY,CALAVERAS CO DA,2,0,0,2
CALAVERAS COUNTY,CALAVERAS CO SD,49,5,12,66
COLUSA COUNTY,COLUSA CO DISTRICT ATTORNEY,2,0,0,2
COLUSA COUNTY,COLUSA COUNTY SD,32,1,10,43
COLUSA COUNTY,COLUSA PD,8,0,0,8
COLUSA COUNTY,WILLIAMS PD,12,1,0,13
CONTRA COSTA COUNTY,ANTIOCH PD,91,4,20,115
CONTRA COSTA COUNTY,BRENTWOOD PD,61,0,0,61
CONTRA COSTA COUNTY,CLAYTON PD,11,1,0,12
CONTRA COSTA COUNTY,CONCORD PD,146,14,20,180
CONTRA COSTA COUNTY,CONTRA COSTA CCD PD,22,0,0,22
CONTRA COSTA COUNTY,CONTRA COSTA CO DA,17,0,0,17
CONTRA COSTA COUNTY,CONTRA COSTA CO SD/CORONER,591,56,45,692
CONTRA COSTA COUNTY,EL CERRITO PD,41,11,0,52
CONTRA COSTA COUNTY,HERCULES PD,20,7,0,27
CONTRA COSTA COUNTY,KENSINGTON PD,9,2,0,11
CONTRA COSTA COUNTY,MARTINEZ PD,35,7,14,56
CONTRA COSTA COUNTY,PINOLE PD,27,0,8,35
CONTRA COSTA COUNTY,PITTSBURG PD,70,4,0,74
CONTRA COSTA COUNTY,PLEASANT HILL PD,42,5,8,55
CONTRA COSTA COUNTY,RICHMOND PD,189,2,26,217
CONTRA COSTA COUNTY,SAN PABLO PD,49,0,0,49
CONTRA COSTA COUNTY,SAN RAMON PD,58,0,0,58
CONTRA COSTA COUNTY,WALNUT CREEK PD,75,34,18,127
DEL NORTE COUNTY,CRESCENT CITY PD,12,5,0,17
DEL NORTE COUNTY,DEL NORTE CO DA,2,0,0,2
DEL NORTE COUNTY,DEL NORTE COUNTY SD,28,12,5,45
EL DORADO COUNTY,EL DORADO CO DA,13,0,0,13
EL DORADO COUNTY,EL DORADO CO SD,164,6,27,197
EL DORADO COUNTY,PLACERVILLE PD,17,2,6,25
EL DORADO COUNTY,SOUTH LAKE TAHOE PD,37,8,8,53
FRESNO COUNTY,CLOVIS PD,94,19,21,134
FRESNO COUNTY,CLOVIS UNIF SCHL DIST PD,10,0,0,10
FRESNO COUNTY,COALINGA PD,21,7,6,34
FRESNO COUNTY,CSU FRESNO DPS,20,0,6,26
FRESNO COUNTY,FIREBAUGH PD,11,7,0,18
FRESNO COUNTY,FOWLER PD,12,3,0,15
FRESNO COUNTY,FRESNO CO DA,38,0,0,38
FRESNO COUNTY,FRESNO CO SD,391,32,37,460
FRESNO COUNTY,FRESNO PD,752,57,90,899
FRESNO COUNTY,FRESNO YOSEMITE INT'L AIRPORT,4,0,0,4
FRESNO COUNTY,HURON PD,6,14,2,22
FRESNO COUNTY,KERMAN PD,18,8,0,26
FRESNO COUNTY,KINGSBURG PD,12,10,4,26
FRESNO COUNTY,MENDOTA PD,10,5,0,15
FRESNO COUNTY,ORANGE COVE PD,13,4,0,17
FRESNO COUNTY,PARLIER PD,17,3,0,20
FRESNO COUNTY,REEDLEY PD,27,2,5,34
FRESNO COUNTY,SANGER PD,32,3,0,35
FRESNO COUNTY,SELMA PD,28,2,4,34
FRESNO COUNTY,STATE CENTER CCD PD,15,0,0,15
GLENN COUNTY,GLENN CO DA,2,0,0,2
GLENN COUNTY,GLENN CO SD/CORONER,25,4,7,36
GLENN COUNTY,ORLAND PD,9,0,0,9
GLENN COUNTY,WILLOWS PD,8,0,0,8
HUMBOLDT COUNTY,ARCATA PD,27,3,5,35
HUMBOLDT COUNTY,CSU HUMBOLDT DPS,11,0,10,21
HUMBOLDT COUNTY,EUREKA PD,48,8,10,66
HUMBOLDT COUNTY,FERNDALE PD,6,1,0,7
HUMBOLDT COUNTY,FORTUNA PD,14,4,7,25
HUMBOLDT COUNTY,HUMBOLDT CO CORONER,4,0,0,4
HUMBOLDT COUNTY,HUMBOLDT CO DA,9,1,0,10
HUMBOLDT COUNTY,HUMBOLDT CO SD,167,26,12,205
HUMBOLDT COUNTY,HUMBOLDT DEPT WELFARE/INVEST,9,0,0,9
HUMBOLDT COUNTY,RIO DELL PD,5,2,0,7
IMPERIAL COUNTY,BRAWLEY PD,35,0,8,43
IMPERIAL COUNTY,CALEXICO PD,39,7,7,53
IMPERIAL COUNTY,CALIPATRIA PD,7,6,0,13
IMPERIAL COUNTY,EL CENTRO PD,44,4,10,58
IMPERIAL COUNTY,IMPERIAL CO DA,11,0,0,11
IMPERIAL COUNTY,IMPERIAL CO SD,98,19,12,129
IMPERIAL COUNTY,IMPERIAL PD,14,5,0,19
IMPERIAL COUNTY,WESTMORLAND PD,5,4,0,9
INYO COUNTY,BISHOP PD,11,5,6,22
INYO COUNTY,INYO CO DA,3,0,0,3
INYO COUNTY,INYO COUNTY SD,36,11,6,53
KERN COUNTY,ARVIN PD,18,5,6,29
KERN COUNTY,BAKERSFIELD PD,356,24,34,414
KERN COUNTY,BEAR VALLEY PD,7,3,9,19
KERN COUNTY,CALIFORNIA CITY PD,11,8,5,24
KERN COUNTY,CSU BAKERSFIELD DPS,11,0,4,15
KERN COUNTY,DELANO PD,46,4,6,56
KERN COUNTY,KERN CO DA,21,0,0,21
KERN COUNTY,KERN CO-DEPT OF PARKS & REC,11,0,0,11
KERN COUNTY,KERN COUNTY SD,887,84,41,1012
KERN COUNTY,KERN HIGH SCHOOL DISTRICT PD,21,0,0,21
KERN COUNTY,MCFARLAND PD,11,15,5,31
KERN COUNTY,RIDGECREST PD,31,8,5,44
KERN COUNTY,SHAFTER PD,21,3,6,30
KERN COUNTY,STALLION SPRINGS PD,3,0,0,3
KERN COUNTY,TAFT PD,14,4,5,23
KERN COUNTY,TEHACHAPI PD,14,5,0,19
KINGS COUNTY,AVENAL PD,15,1,0,16
KINGS COUNTY,CORCORAN PD,18,3,7,28
KINGS COUNTY,HANFORD PD,52,6,15,73
KINGS COUNTY,KINGS CO DA,11,1,0,12
KINGS COUNTY,KINGS CO SD,75,7,16,98
KINGS COUNTY,"KINGS CO-HUMAN SVCS,WELFARE FD",6,0,0,6
KINGS COUNTY,LEMOORE PD,29,2,0,31
LAKE COUNTY,CLEARLAKE PD,19,3,5,27
LAKE COUNTY,LAKE CO DA,8,0,0,8
LAKE COUNTY,LAKE CO SD,53,1,10,64
LAKE COUNTY,LAKEPORT PD,10,2,0,12
LASSEN COUNTY,LASSEN CO DA,1,0,0,1
LASSEN COUNTY,LASSEN CO SD,31,19,7,57
LASSEN COUNTY,SUSANVILLE PD,14,2,0,16
LOS ANGELES COUNTY,ALHAMBRA PD,79,9,14,102
LOS ANGELES COUNTY,ARCADIA PD,67,12,11,90
LOS ANGELES COUNTY,AZUSA PD,60,6,11,77
LOS ANGELES COUNTY,BALDWIN PARK PD,67,4,10,81
LOS ANGELES COUNTY,BELL GARDENS PD,50,0,4,54
LOS ANGELES COUNTY,BELL PD,31,6,7,44
LOS ANGELES COUNTY,BEVERLY HILLS PD,112,20,18,150
LOS ANGELES COUNTY,BURBANK AIRPORT AUTH PD,27,0,0,27
LOS ANGELES COUNTY,BURBANK PD,155,12,14,181
LOS ANGELES COUNTY,BURLINGTON NORTHRN SANTA FE RR,27,0,0,27
LOS ANGELES COUNTY,CA DEPT CORPORATIONS,3,0,0,3
LOS ANGELES COUNTY,CA DEPT INDUSTRIAL RELATIONS,6,0,0,6
LOS ANGELES COUNTY,CERRITOS CCD PD,10,0,0,10
LOS ANGELES COUNTY,CLAREMONT PD,35,3,7,45
LOS ANGELES COUNTY,COMPTON UNIF SCH DIST PD,30,0,0,30
LOS ANGELES COUNTY,COVINA PD,51,0,11,62
LOS ANGELES COUNTY,CSU DOMINGUEZ HILLS DPS,17,0,6,23
LOS ANGELES COUNTY,CSU LONG BEACH PD,25,0,8,33
LOS ANGELES COUNTY,CSU LOS ANGELES DPS,17,0,7,24
LOS ANGELES COUNTY,CSU NORTHRIDGE DPS,21,0,5,26
LOS ANGELES COUNTY,CSU POMONA DPS,18,0,7,25
LOS ANGELES COUNTY,CULVER CITY PD,105,21,9,135
LOS ANGELES COUNTY,DOWNEY PD,115,0,15,130
LOS ANGELES COUNTY,EL CAMINO CCD PD,24,0,3,27
LOS ANGELES COUNTY,EL MONTE PD,121,57,17,195
LOS ANGELES COUNTY,EL SEGUNDO PD,58,0,0,58
LOS ANGELES COUNTY,GARDENA PD,93,9,0,102
LOS ANGELES COUNTY,GLENDALE CCD PD,10,0,0,10
LOS ANGELES COUNTY,GLENDALE PD,238,12,28,278
LOS ANGELES COUNTY,GLENDORA PD,51,7,12,70
LOS ANGELES COUNTY,HACIENDA LA PUENTE USD,6,0,0,6
LOS ANGELES COUNTY,HAWTHORNE PD,95,5,0,100
LOS ANGELES COUNTY,HERMOSA BEACH PD,32,5,0,37
LOS ANGELES COUNTY,HUNTINGTON PARK PD,66,9,10,85
LOS ANGELES COUNTY,INGLEWOOD PD,178,0,20,198
LOS ANGELES COUNTY,INGLEWOOD UNIF SCH DIST PD,8,2,0,10
LOS ANGELES COUNTY,IRWINDALE PD,26,3,7,36
LOS ANGELES COUNTY,LA VERNE PD,40,16,9,65
LOS ANGELES COUNTY,LONG BEACH PD,818,38,55,911
LOS ANGELES COUNTY,LOS ANGELES CITY DPT GEN SVCS,93,0,9,102
LOS ANGELES COUNTY,LOS ANGELES CITY HOUSING AUTH,1,0,0,1
LOS ANGELES COUNTY,LOS ANGELES CITY PARK RANGER,12,0,0,12
LOS ANGELES COUNTY,LOS ANGELES CO CORONER,44,0,0,44
LOS ANGELES COUNTY,LOS ANGELES CO DA,271,0,1,272
LOS ANGELES COUNTY,LOS ANGELES CO SD,9127,900,586,10613
LOS ANGELES COUNTY,LOS ANGELES PD,9844,412,573,10829
LOS ANGELES COUNTY,LOS ANGELES PORT PD,124,5,6,135
LOS ANGELES COUNTY,LOS ANGELES SCHOOL PD,348,0,0,348
LOS ANGELES COUNTY,LOS ANGELES WORLD AIRPORTS PD,502,0,0,502
LOS ANGELES COUNTY,MANHATTAN BEACH PD,61,5,0,66
LOS ANGELES COUNTY,MONROVIA PD,49,5,9,63
LOS ANGELES COUNTY,MONTEBELLO PD,74,17,12,103
LOS ANGELES COUNTY,MONTEBELLO UNIFIED SCHOOL DIST,3,2,0,5
LOS ANGELES COUNTY,MONTEREY PARK PD,68,30,13,111
LOS ANGELES COUNTY,PALOS VERDES ESTATES PD,23,18,11,52
LOS ANGELES COUNTY,PASADENA CITY CCD PD,7,1,5,13
LOS ANGELES COUNTY,PASADENA PD,235,21,33,289
LOS ANGELES COUNTY,POMONA PD,152,16,29,197
LOS ANGELES COUNTY,REDONDO BEACH PD,88,14,14,116
LOS ANGELES COUNTY,SAN FERNANDO PD,31,18,6,55
LOS ANGELES COUNTY,SAN GABRIEL PD,52,5,4,61
LOS ANGELES COUNTY,SAN MARINO PD,26,0,7,33
LOS ANGELES COUNTY,SANTA MONICA CCD PD,15,0,4,19
LOS ANGELES COUNTY,SANTA MONICA PD,205,0,12,217
LOS ANGELES COUNTY,SIERRA MADRE PD,15,6,4,25
LOS ANGELES COUNTY,SIGNAL HILL PD,34,2,7,43
LOS ANGELES COUNTY,SOUTH BAY REG PUB COMM AUTH,0,0,50,50
LOS ANGELES COUNTY,SOUTH GATE PD,70,4,9,83
LOS ANGELES COUNTY,SOUTH PASADENA PD,34,17,9,60
LOS ANGELES COUNTY,TORRANCE PD,208,0,22,230
LOS ANGELES COUNTY,UC LOS ANGELES PD,58,0,12,70
LOS ANGELES COUNTY,UNION PACIFIC RAILROAD,59,0,0,59
LOS ANGELES COUNTY,VERNON PD,47,0,7,54
LOS ANGELES COUNTY,WEST COVINA PD,95,14,14,123
LOS ANGELES COUNTY,WHITTIER PD,115,4,13,132
MADERA COUNTY,CHOWCHILLA PD,14,3,5,22
MADERA COUNTY,MADERA CO DA,7,0,0,7
MADERA COUNTY,MADERA CO SD,69,48,7,124
MADERA COUNTY,MADERA PD,58,0,8,66
MARIN COUNTY,BELVEDERE PD,8,2,0,10
MARIN COUNTY,FAIRFAX PD,11,2,6,19
MARIN COUNTY,MARIN CCD PD,8,0,0,8
MARIN COUNTY,MARIN CO DA,9,0,0,9
MARIN COUNTY,MARIN CO SD,201,0,48,249
MARIN COUNTY,MARIN MUNCPL WATER DIST,6,0,0,6
MARIN COUNTY,MILL VALLEY PD,21,2,0,23
MARIN COUNTY,NOVATO PD,60,0,13,73
MARIN COUNTY,ROSS PD,8,1,0,9
MARIN COUNTY,SAN ANSELMO PD,17,4,5,26
MARIN COUNTY,SAN RAFAEL PD,61,6,13,80
MARIN COUNTY,SAUSALITO PD,16,0,0,16
MARIN COUNTY,TIBURON PD,13,5,0,18
MARIN COUNTY,TWIN CITIES PD,31,1,10,42
MARIPOSA COUNTY,MARIPOSA CO DA,2,0,0,2
MARIPOSA COUNTY,MARIPOSA CO SD,40,14,0,54
MENDOCINO COUNTY,FORT BRAGG PD,16,0,0,16
MENDOCINO COUNTY,MENDOCINO CO DA,6,0,0,6
MENDOCINO COUNTY,MENDOCINO CO SD,115,7,11,133
MENDOCINO COUNTY,UKIAH PD,25,3,11,39
MENDOCINO COUNTY,WILLITS PD,12,0,7,19
MERCED COUNTY,ATWATER PD,33,4,9,46
MERCED COUNTY,DOS PALOS PD,7,5,3,15
MERCED COUNTY,GUSTINE PD,8,8,1,17
MERCED COUNTY,LIVINGSTON PD,18,8,6,32
MERCED COUNTY,LOS BANOS PD,36,0,11,47
MERCED COUNTY,MERCED CCD PD,3,0,0,3
MERCED COUNTY,MERCED CO DA,10,0,0,10
MERCED COUNTY,MERCED CO SD,108,38,12,158
MERCED COUNTY,MERCED PD,87,18,15,120
MERCED COUNTY,UC MERCED PD,11,0,6,17
MODOC COUNTY,ALTURAS PD,6,0,0,6
MODOC COUNTY,MODOC CO DA,1,0,0,1
MODOC COUNTY,MODOC CO SD,14,0,3,17
MONO COUNTY,MAMMOTH LAKES PD,18,0,0,18
MONO COUNTY,MONO CO DA,2,0,0,2
MONO COUNTY,MONO CO SD,28,1,18,47
MONTEREY COUNTY,CARMEL PD,13,4,5,22
MONTEREY COUNTY,CSU MONTEREY BAY PD,13,0,0,13
MONTEREY COUNTY,DEL REY OAKS PD,6,12,0,18
MONTEREY COUNTY,GONZALES PD,11,2,0,13
MONTEREY COUNTY,GREENFIELD PD,14,0,0,14
MONTEREY COUNTY,KING CITY PD,16,2,0,18
MONTEREY COUNTY,MARINA PD,34,4,0,38
MONTEREY COUNTY,MONTEREY CO DA,22,0,0,22
MONTEREY COUNTY,MONTEREY CO EMER COMM,0,0,55,55
MONTEREY COUNTY,MONTEREY CO SHERIFF'S OFFICE,287,5,0,292
MONTEREY COUNTY,MONTEREY PD,46,0,0,46
MONTEREY COUNTY,MONTEREY REG AIRPORT DIST PD,7,0,0,7
MONTEREY COUNTY,PACIFIC GROVE PD,19,4,0,23
MONTEREY COUNTY,SALINAS PD,147,14,0,161
MONTEREY COUNTY,SAND CITY PD,10,2,0,12
MONTEREY COUNTY,SEASIDE PD,39,5,0,44
MONTEREY COUNTY,SOLEDAD PD,18,2,0,20
NAPA COUNTY,CALISTOGA PD,10,2,3,15
NAPA COUNTY,NAPA CO DA,8,0,0,8
NAPA COUNTY,NAPA CO SD,101,0,0,101
NAPA COUNTY,NAPA PD,65,0,25,90
NAPA COUNTY,NAPA VALLEY COLLEGE DPS,4,0,0,4
NAPA COUNTY,NAPA VALLEY RR PD,1,0,0,1
NAPA COUNTY,SAINT HELENA PD,11,1,5,17
NEVADA COUNTY,GRASS VALLEY PD,22,8,6,36
NEVADA COUNTY,NEVADA CITY PD,10,5,0,15
NEVADA COUNTY,NEVADA CO DA,3,0,0,3
NEVADA COUNTY,NEVADA CO SD,65,11,14,90
NEVADA COUNTY,TRUCKEE PD,22,2,0,24
ORANGE COUNTY,ANAHEIM PD,359,9,34,402
ORANGE COUNTY,BREA PD,93,0,16,109
ORANGE COUNTY,BUENA PARK PD,84,8,11,103
ORANGE COUNTY,COSTA MESA COMM DEPT,0,0,25,25
ORANGE COUNTY,COSTA MESA PD,132,6,0,138
ORANGE COUNTY,CSU FULLERTON PD,26,0,8,34
ORANGE COUNTY,CYPRESS PD,54,0,0,54
ORANGE COUNTY,FOUNTAIN VALLEY PD,58,1,11,70
ORANGE COUNTY,FULLERTON PD,143,15,19,177
ORANGE COUNTY,GARDEN GROVE PD,152,26,18,196
ORANGE COUNTY,HUNTINGTON BEACH PD,203,9,27,239
ORANGE COUNTY,IRVINE PD,196,4,20,220
ORANGE COUNTY,IRVINE VALLEY CCD PD,4,0,2,6
ORANGE COUNTY,LA HABRA PD,68,12,10,90
ORANGE COUNTY,LA PALMA PD,23,5,9,37
ORANGE COUNTY,LAGUNA BEACH PD,45,6,12,63
ORANGE COUNTY,LOS ALAMITOS PD,22,3,0,25
ORANGE COUNTY,NEWPORT BEACH PD,129,10,18,157
ORANGE COUNTY,ORANGE CO DA,125,0,0,125
ORANGE COUNTY,ORANGE CO DA WELFARE/FRAUD INV,33,0,0,33
ORANGE COUNTY,ORANGE CO SD/CORONER,1809,236,63,2108
ORANGE COUNTY,ORANGE PD,151,12,15,178
ORANGE COUNTY,PLACENTIA PD,46,2,14,62
ORANGE COUNTY,SADDLEBACK CCD PD,7,0,0,7
ORANGE COUNTY,SANTA ANA PD,324,19,30,373
ORANGE COUNTY,SANTA ANA UNIF SCHL DIST PD,25,3,0,28
ORANGE COUNTY,SEAL BEACH PD,31,5,0,36
ORANGE COUNTY,TUSTIN PD,93,7,13,113
ORANGE COUNTY,UC IRVINE PD,32,0,9,41
ORANGE COUNTY,WEST CITIES COMM CTR,0,0,24,24
ORANGE COUNTY,WESTMINSTER PD,89,12,14,115
PLACER COUNTY,AUBURN PD,20,7,7,34
PLACER COUNTY,LINCOLN PD,21,3,5,29
PLACER COUNTY,PLACER CO DA,9,0,0,9
PLACER COUNTY,PLACER COUNTY SD,232,89,34,355
PLACER COUNTY,ROCKLIN PD,52,6,17,75
PLACER COUNTY,ROSEVILLE PD,119,6,24,149
PLACER COUNTY,SIERRA COLLEGE PD (OBS),3,0,0,3
PLUMAS COUNTY,PLUMAS CO SD,31,15,10,56
RIVERSIDE COUNTY,BANNING PD,32,1,9,42
RIVERSIDE COUNTY,BEAUMONT PD,53,0,13,66
RIVERSIDE COUNTY,BLYTHE PD,21,4,8,33
RIVERSIDE COUNTY,CATHEDRAL CITY PD,51,18,19,88
RIVERSIDE COUNTY,CORONA PD,146,3,25,174
RIVERSIDE COUNTY,DESERT HOT SPRINGS PD,31,2,1,34
RIVERSIDE COUNTY,HEMET PD,54,0,18,72
RIVERSIDE COUNTY,INDIO PD,67,4,16,87
RIVERSIDE COUNTY,MOUNT SAN JACINTO CCD PD,3,0,0,3
RIVERSIDE COUNTY,MURRIETA PD,85,4,20,109
RIVERSIDE COUNTY,PALM SPRINGS PD,87,15,17,119
RIVERSIDE COUNTY,RIVERSIDE CCD PD,19,8,0,27
RIVERSIDE COUNTY,RIVERSIDE CO DA,113,0,2,115
RIVERSIDE COUNTY,RIVERSIDE CO PUBLIC SOCIAL SER,27,0,0,27
RIVERSIDE COUNTY,RIVERSIDE CO SD,2011,52,162,2225
RIVERSIDE COUNTY,RIVERSIDE PD,371,0,49,420
RIVERSIDE COUNTY,UC RIVERSIDE PD,27,0,8,35
SACRAMENTO COUNTY,CA ALCOHOLIC BEVERAGE CONTROL,175,0,0,175
SACRAMENTO COUNTY,CA ASSEMBLY SGT AT ARMS LEGIS,20,0,0,20
SACRAMENTO COUNTY,CA DEPT CONSUMER AFF DEN BD,16,0,0,16
SACRAMENTO COUNTY,CA DEPT CONSUMER AFF INVEST,57,0,0,57
SACRAMENTO COUNTY,CA DEPT CONSUMER AFF MED BD,88,0,0,88
SACRAMENTO COUNTY,CA DEPT DEVELOPMENTAL OPS,88,0,0,88
SACRAMENTO COUNTY,CA DEPT EMPLOYMENT DEVELOPMENT,42,0,0,42
SACRAMENTO COUNTY,CA DEPT FISH & GAME,348,5,0,353
SACRAMENTO COUNTY,CA DEPT HEALTH CARE SVCS,127,0,0,127
SACRAMENTO COUNTY,CA DEPT INSURANCE FRAUD,210,0,0,210
SACRAMENTO COUNTY,CA DEPT JUSTICE,304,0,0,304
SACRAMENTO COUNTY,CA DEPT MENTAL HEALTH,23,0,0,23
SACRAMENTO COUNTY,CA DEPT MOTOR VEHICLES,213,0,0,213
SACRAMENTO COUNTY,CA DEPT PARKS & RECREATION,611,0,73,684
SACRAMENTO COUNTY,CA DEPT PUB HEALTH FOOD/DRUG,106,0,0,106
SACRAMENTO COUNTY,CA DEPT SOCIAL SERVICES,54,0,0,54
SACRAMENTO COUNTY,CA DEPT TOXIC SUBSTANCES CNTL,12,0,0,12
SACRAMENTO COUNTY,CA FRANCHISE TAX BOARD,41,0,0,41
SACRAMENTO COUNTY,CA HIGHWAY PATROL,7417,0,957,8374
SACRAMENTO COUNTY,CA HORSE RACING BOARD,10,0,0,10
SACRAMENTO COUNTY,CA SECRETARY OF STATE OFC INV,7,0,0,7
SACRAMENTO COUNTY,CA STATE CONTROLLER - INVEST,1,0,0,1
SACRAMENTO COUNTY,CA STATE FAIR PD,2,0,0,2
SACRAMENTO COUNTY,CA STATE LOTTERY,30,0,0,30
SACRAMENTO COUNTY,CAL - EMA,8,0,0,8
SACRAMENTO COUNTY,CAL FIRE,186,0,0,186
SACRAMENTO COUNTY,CITRUS HEIGHTS PD,87,16,24,127
SACRAMENTO COUNTY,CSU SACRAMENTO DPS,24,0,8,32
SACRAMENTO COUNTY,ELK GROVE PD,128,10,22,160
SACRAMENTO COUNTY,FOLSOM PD,73,7,17,97
SACRAMENTO COUNTY,GALT PD,33,2,8,43
SACRAMENTO COUNTY,ISLETON PD,4,0,0,4
SACRAMENTO COUNTY,LOS RIOS CCD PD,31,3,0,34
SACRAMENTO COUNTY,SACRAMENTO CO CORONER,13,0,0,13
SACRAMENTO COUNTY,SACRAMENTO CO DA,36,0,0,36
SACRAMENTO COUNTY,SACRAMENTO CO HUMAN ASST INV,21,0,0,21
SACRAMENTO COUNTY,SACRAMENTO CO REG PARKS DEPT,14,0,0,14
SACRAMENTO COUNTY,SACRAMENTO CO SD,1212,441,59,1712
SACRAMENTO COUNTY,SACRAMENTO PD,653,81,80,814
SACRAMENTO COUNTY,TWIN RIVERS USD PD,23,8,0,31
SAN BENITO COUNTY,HOLLISTER PD,21,1,0,22
SAN BENITO COUNTY,SAN BENITO CO DA,2,0,0,2
SAN BENITO COUNTY,SAN BENITO CO OES,0,0,2,2
SAN BENITO COUNTY,SAN BENITO CO SD,28,6,0,34
SAN BERNARDINO COUNTY,BARSTOW PD,38,6,7,51
SAN BERNARDINO COUNTY,CHINO PD,98,1,19,118
SAN BERNARDINO COUNTY,COLTON PD,46,2,9,57
SAN BERNARDINO COUNTY,CSU SAN BERNARDINO DPS,14,0,12,26
SAN BERNARDINO COUNTY,FONTANA PD,175,3,26,204
SAN BERNARDINO COUNTY,FONTANA UNIFIED SCHOOL DIST,16,0,10,26
SAN BERNARDINO COUNTY,HESPERIA UNIFIED SCHOOL DIST,5,0,0,5
SAN BERNARDINO COUNTY,MONTCLAIR PD,51,7,9,67
SAN BERNARDINO COUNTY,ONTARIO PD,226,8,39,273
SAN BERNARDINO COUNTY,REDLANDS PD,79,13,15,107
SAN BERNARDINO COUNTY,RIALTO PD,91,2,14,107
SAN BERNARDINO COUNTY,SAN BERNARDINO CCD PD,9,0,0,9
SAN BERNARDINO COUNTY,SAN BERNARDINO CO DA,45,0,0,45
SAN BERNARDINO COUNTY,SAN BERNARDINO CO SD,1704,219,149,2072
SAN BERNARDINO COUNTY,SAN BERNARDINO PD,287,24,40,351
SAN BERNARDINO COUNTY,SAN BERNARDINO UNIF SCHL DIST,23,2,6,31
SAN BERNARDINO COUNTY,SNOWLINE JOINT UNIF SCHL DIST,3,1,0,4
SAN BERNARDINO COUNTY,UPLAND PD,73,9,17,99
SAN DIEGO COUNTY,CARLSBAD PD,108,3,17,128
SAN DIEGO COUNTY,CHULA VISTA PD,208,11,24,243
SAN DIEGO COUNTY,CORONADO PD,43,2,8,53
SAN DIEGO COUNTY,CSU SAN DIEGO DPS,22,0,10,32
SAN DIEGO COUNTY,CSU SAN MARCOS DPS,15,0,7,22
SAN DIEGO COUNTY,EL CAJON PD,114,20,17,151
SAN DIEGO COUNTY,ESCONDIDO PD,151,12,23,186
SAN DIEGO COUNTY,GROSSMONT-CUYAMACA CCD PD,10,0,0,10
SAN DIEGO COUNTY,LA MESA PD,66,2,17,85
SAN DIEGO COUNTY,MIRA COSTA CCD PD,9,0,3,12
SAN DIEGO COUNTY,NATIONAL CITY PD,81,11,15,107
SAN DIEGO COUNTY,OCEANSIDE PD,203,3,28,234
SAN DIEGO COUNTY,PALOMAR CCD PD,11,0,0,11
SAN DIEGO COUNTY,SAN DIEGO CCD PD,38,0,8,46
SAN DIEGO COUNTY,SAN DIEGO CITY SCHOOLS PD,38,0,8,46
SAN DIEGO COUNTY,SAN DIEGO CO DA,178,0,0,178
SAN DIEGO COUNTY,SAN DIEGO CO SD,1220,117,116,1453
SAN DIEGO COUNTY,"SAN DIEGO HARBOR PD, PORT OF",123,0,14,137
SAN DIEGO COUNTY,SAN DIEGO PD,1800,38,151,1989
SAN DIEGO COUNTY,SOUTHWESTERN CCD PD,9,0,0,9
SAN DIEGO COUNTY,UC SAN DIEGO PD,30,0,10,40
SAN FRANCISCO COUNTY,CSU SAN FRANCISCO DPS,26,0,5,31
SAN FRANCISCO COUNTY,SAN FRAN INT'L AIRPORT COMM,0,0,37,37
SAN FRANCISCO COUNTY,SAN FRANCISCO CCD PD,29,0,0,29
SAN FRANCISCO COUNTY,SAN FRANCISCO CO DA,29,0,0,29
SAN FRANCISCO COUNTY,SAN FRANCISCO CO MED EXAM,11,0,0,11
SAN FRANCISCO COUNTY,SAN FRANCISCO CO SD,844,0,0,844
SAN FRANCISCO COUNTY,SAN FRANCISCO DEPT EMER MGT,0,0,194,194
SAN FRANCISCO COUNTY,SAN FRANCISCO MUNICIPAL RWY PD,3,0,0,3
SAN FRANCISCO COUNTY,SAN FRANCISCO PD,2102,32,0,2134
SAN FRANCISCO COUNTY,SUPREME COURT OF CALIFORNIA,1,0,0,1
SAN FRANCISCO COUNTY,UC SAN FRANCISCO PD,51,0,8,59
SAN JOAQUIN COUNTY,ESCALON PD,10,13,0,23
SAN JOAQUIN COUNTY,LODI PD,70,4,22,96
SAN JOAQUIN COUNTY,MANTECA PD,60,20,9,89
SAN JOAQUIN COUNTY,RIPON PD,22,5,8,35
SAN JOAQUIN COUNTY,SAN JOAQUIN CO DA,22,0,0,22
SAN JOAQUIN COUNTY,SAN JOAQUIN CO SD,284,18,33,335
SAN JOAQUIN COUNTY,SAN JOAQUIN DELTA COLLEGE PD,10,0,6,16
SAN JOAQUIN COUNTY,STOCKTON PD,315,26,41,382
SAN JOAQUIN COUNTY,STOCKTON UNIF SCHL DIST PD,20,1,8,29
SAN JOAQUIN COUNTY,TRACY PD,82,0,15,97
SAN LUIS OBISPO COUNTY,ARROYO GRANDE PD,24,2,7,33
SAN LUIS OBISPO COUNTY,ATASCADERO PD,27,1,9,37
SAN LUIS OBISPO COUNTY,CPSU SAN LUIS OBISPO PD,18,0,6,24
SAN LUIS OBISPO COUNTY,CUESTA CCD DPS,6,0,0,6
SAN LUIS OBISPO COUNTY,GROVER BEACH PD,17,2,8,27
SAN LUIS OBISPO COUNTY,MORRO BAY PD,18,0,6,24
SAN LUIS OBISPO COUNTY,PASO ROBLES PD,28,6,9,43
SAN LUIS OBISPO COUNTY,PISMO BEACH PD,22,2,7,31
SAN LUIS OBISPO COUNTY,SAN LUIS OBISPO CO DA,13,0,0,13
SAN LUIS OBISPO COUNTY,SAN LUIS OBISPO CO SD,146,17,15,178
SAN LUIS OBISPO COUNTY,SAN LUIS OBISPO PD,53,0,13,66
SAN MATEO COUNTY,ATHERTON PD,18,4,14,36
SAN MATEO COUNTY,BELMONT PD,28,4,9,41
SAN MATEO COUNTY,BRISBANE PD,12,0,0,12
SAN MATEO COUNTY,BROADMOOR PD,8,25,0,33
SAN MATEO COUNTY,BURLINGAME PD,36,5,17,58
SAN MATEO COUNTY,COLMA PD,17,0,5,22
SAN MATEO COUNTY,DALY CITY PD,107,1,18,126
SAN MATEO COUNTY,EAST PALO ALTO PD,39,0,0,39
SAN MATEO COUNTY,FOSTER CITY PD,35,6,13,54
SAN MATEO COUNTY,HILLSBOROUGH PD,25,1,7,33
SAN MATEO COUNTY,MENLO PARK PD,46,3,17,66
SAN MATEO COUNTY,PACIFICA PD,33,9,0,42
SAN MATEO COUNTY,REDWOOD CITY PD,89,11,11,111
SAN MATEO COUNTY,SAN BRUNO PD,44,7,7,58
SAN MATEO COUNTY,SAN MATEO CO CORONER,9,0,0,9
SAN MATEO COUNTY,SAN MATEO CO DA,14,0,0,14
SAN MATEO COUNTY,SAN MATEO CO PUB SFTY COMM CTR,0,0,40,40
SAN MATEO COUNTY,SAN MATEO CO SD,314,46,0,360
SAN MATEO COUNTY,SAN MATEO PD,104,6,15,125
SAN MATEO COUNTY,SOUTH SAN FRANCISCO PD,74,14,17,105
SANTA BARBARA COUNTY,ALLAN HANCOCK CCD PD,3,4,3,10
SANTA BARBARA COUNTY,GUADALUPE PD,13,4,2,19
SANTA BARBARA COUNTY,LOMPOC PD,50,2,13,65
SANTA BARBARA COUNTY,SANTA BARBARA CO DA,20,0,0,20
SANTA BARBARA COUNTY,SANTA BARBARA CO SD,259,27,31,317
SANTA BARBARA COUNTY,SANTA BARBARA PD,136,11,18,165
SANTA BARBARA COUNTY,SANTA MARIA PD,98,4,19,121
SANTA BARBARA COUNTY,UC SANTA BARBARA PD,30,0,7,37
SANTA CLARA COUNTY,CAMPBELL PD,41,11,12,64
SANTA CLARA COUNTY,CSU SAN JOSE PD,28,0,6,34
SANTA CLARA COUNTY,FOOTHILL-DEANZA CCD PD,9,0,0,9
SANTA CLARA COUNTY,GILROY PD,59,8,14,81
SANTA CLARA COUNTY,LOS ALTOS PD,30,4,8,42
SANTA CLARA COUNTY,LOS GATOS PD,38,9,6,53
SANTA CLARA COUNTY,MILPITAS PD,80,5,14,99
SANTA CLARA COUNTY,MORGAN HILL PD,35,5,9,49
SANTA CLARA COUNTY,MOUNTAIN VIEW EMERG COMM,0,0,18,18
SANTA CLARA COUNTY,MOUNTAIN VIEW PD,92,20,0,112
SANTA CLARA COUNTY,PALO ALTO PD,79,9,26,114
SANTA CLARA COUNTY,SAN JOSE PD,1099,86,142,1327
SANTA CLARA COUNTY,SAN JOSE UNIF SCHL DIST PD,1,0,0,1
SANTA CLARA COUNTY,SAN JOSE/EVERGREEN CCD PD,5,0,1,6
SANTA CLARA COUNTY,SANTA CLARA CO COMM DEPT,0,0,72,72
SANTA CLARA COUNTY,SANTA CLARA CO DA,66,0,0,66
SANTA CLARA COUNTY,SANTA CLARA CO SD,451,83,0,534
SANTA CLARA COUNTY,SANTA CLARA PD,132,29,20,181
SANTA CLARA COUNTY,SUNNYVALE DPS,199,0,22,221
SANTA CLARA COUNTY,WEST VALLEY CCD PD,9,3,0,12
SANTA CRUZ COUNTY,CAPITOLA PD,22,4,0,26
SANTA CRUZ COUNTY,SANTA CRUZ CO DA,13,0,0,13
SANTA CRUZ COUNTY,SANTA CRUZ CO SD,136,26,0,162
SANTA CRUZ COUNTY,SANTA CRUZ PD,86,1,0,87
SANTA CRUZ COUNTY,SCOTTS VALLEY PD,20,6,6,32
SANTA CRUZ COUNTY,UC SANTA CRUZ PD,16,0,9,25
SANTA CRUZ COUNTY,WATSONVILLE PD,64,0,0,64
SHASTA COUNTY,ANDERSON PD,15,0,0,15
SHASTA COUNTY,REDDING PD,95,0,0,95
SHASTA COUNTY,SHASTA AREA SAFETY COMM AGCY,0,0,43,43
SHASTA COUNTY,SHASTA CO DA,12,0,0,12
SHASTA COUNTY,SHASTA CO MARSHAL,22,0,0,22
SHASTA COUNTY,SHASTA CO SD,145,17,0,162
SIERRA COUNTY,SIERRA CO SD,9,3,0,12
SISKIYOU COUNTY,ETNA PD,1,2,0,3
SISKIYOU COUNTY,LAKE SHASTINA DISTRICT PD,3,0,0,3
SISKIYOU COUNTY,MOUNT SHASTA PD,8,3,2,13
SISKIYOU COUNTY,SISKIYOU CO DA,2,0,0,2
SISKIYOU COUNTY,SISKIYOU CO SD,79,6,10,95
SISKIYOU COUNTY,TULELAKE PD,2,0,0,2
SISKIYOU COUNTY,WEED PD,10,1,5,16
SISKIYOU COUNTY,YREKA PD,14,1,4,19
SOLANO COUNTY,BENICIA PD,34,0,14,48
SOLANO COUNTY,DIXON PD,24,2,0,26
SOLANO COUNTY,FAIRFIELD PD,117,0,22,139
SOLANO COUNTY,RIO VISTA PD,9,5,0,14
SOLANO COUNTY,SOLANO CCD PD,3,0,0,3
SOLANO COUNTY,SOLANO CO DA,10,0,0,10
SOLANO COUNTY,SOLANO CO SD,106,16,16,138
SOLANO COUNTY,SUISUN CITY PD,21,2,6,29
SOLANO COUNTY,VACAVILLE PD,90,4,18,112
SOLANO COUNTY,VALLEJO PD,93,6,21,120
SONOMA COUNTY,CLOVERDALE PD,12,2,6,20
SONOMA COUNTY,COTATI PD,10,0,4,14
SONOMA COUNTY,CSU SONOMA PD,11,0,6,17
SONOMA COUNTY,HEALDSBURG PD,16,1,6,23
SONOMA COUNTY,PETALUMA PD,62,0,13,75
SONOMA COUNTY,ROHNERT PARK DPS,55,2,14,71
SONOMA COUNTY,SANTA ROSA JUNIOR COLLEGE PD,12,0,7,19
SONOMA COUNTY,SANTA ROSA PD,164,0,25,189
SONOMA COUNTY,SEBASTOPOL PD,13,10,6,29
SONOMA COUNTY,SONOMA CO DA,15,0,0,15
SONOMA COUNTY,"SONOMA CO HUM SRV,WLF FRD INV",6,0,0,6
SONOMA COUNTY,SONOMA CO SHERIFF'S OFFICE,231,6,33,270
STANISLAUS COUNTY,CERES DPS,53,7,11,71
STANISLAUS COUNTY,CSU STANISLAUS DPS,12,0,4,16
STANISLAUS COUNTY,MODESTO PD,218,20,0,238
STANISLAUS COUNTY,NEWMAN PD,11,5,0,16
STANISLAUS COUNTY,OAKDALE PD,21,8,6,35
STANISLAUS COUNTY,STANISLAUS CO DA,15,0,0,15
STANISLAUS COUNTY,STANISLAUS CO SD,176,23,0,199
STANISLAUS COUNTY,STANISLAUS REGIONAL 9-1-1,0,0,49,49
STANISLAUS COUNTY,TURLOCK PD,79,0,17,96
SUTTER COUNTY,SUTTER CO DA,8,0,0,8
SUTTER COUNTY,SUTTER CO SD,99,30,14,143
SUTTER COUNTY,YUBA CITY PD,62,5,12,79
SUTTER COUNTY,CORNING PD,14,0,4,18
SUTTER COUNTY,RED BLUFF PD,23,1,7,31
SUTTER COUNTY,TEHAMA CO DA,5,0,0,5
SUTTER COUNTY,TEHAMA CO SD,75,9,7,91
TRINITY COUNTY,TRINITY CO DIST ATTORNEY,1,0,0,1
TRINITY COUNTY,TRINITY CO MARSHAL,2,0,0,2
TRINITY COUNTY,TRINITY COUNTY SD,18,15,2,35
TULARE COUNTY,COLLEGE OF THE SEQUOIAS PD,6,1,1,8
TULARE COUNTY,DINUBA PD,35,5,6,46
TULARE COUNTY,EXETER PD,19,6,0,25
TULARE COUNTY,FARMERSVILLE PD,13,6,2,21
TULARE COUNTY,LINDSAY DPS,17,4,3,24
TULARE COUNTY,PORTERVILLE PD,56,9,14,79
TULARE COUNTY,TULARE CO DA,31,0,0,31
TULARE COUNTY,TULARE CO SD,487,31,18,536
TULARE COUNTY,TULARE PD,71,0,11,82
TULARE COUNTY,VISALIA PD,135,10,27,172
TULARE COUNTY,WOODLAKE PD,12,4,1,17
TUOLUMNE COUNTY,SONORA PD,9,4,5,18
TUOLUMNE COUNTY,TUOLUMNE CO DA,2,0,0,2
TUOLUMNE COUNTY,TUOLUMNE CO SD,61,6,13,80
VENTURA COUNTY,CSU CHANNEL ISLANDS PD,15,0,4,19
VENTURA COUNTY,OXNARD PD,225,12,22,259
VENTURA COUNTY,PORT HUENEME PD,24,10,5,39
VENTURA COUNTY,SANTA PAULA PD,27,35,7,69
VENTURA COUNTY,SIMI VALLEY PD,123,6,18,147
VENTURA COUNTY,VENTURA CO CCD PD,13,0,0,13
VENTURA COUNTY,VENTURA CO DA,46,0,0,46
VENTURA COUNTY,VENTURA CO SD,701,26,34,761
VENTURA COUNTY,VENTURA PD,118,0,13,131
YOLO COUNTY,DAVIS PD,61,5,13,79
YOLO COUNTY,UC DAVIS PD,45,0,10,55
YOLO COUNTY,WEST SACRAMENTO PD,66,0,0,66
YOLO COUNTY,WINTERS PD,10,4,0,14
YOLO COUNTY,WOODLAND PD,59,1,0,60
YOLO COUNTY,YOLO CO COMM EMER,0,0,36,36
YOLO COUNTY,YOLO CO DA,10,0,0,10
YOLO COUNTY,YOLO CO SD,84,12,0,96
YUBA COUNTY,MARYSVILLE PD,19,19,5,43
YUBA COUNTY,WHEATLAND PD,7,0,0,7
YUBA COUNTY,YUBA CO SD,83,23,12,118
YUBA COUNTY,YUBA COMMUNITY COLL DIST PD,6,2,0,8
YUBA COUNTY,** GRAND TOTAL,79041,5757,8079,92877
